Sale 1 Price;Sale 2 Price;Date Sale 1;Date Sale 2;City;Time Interval;Atlanta;Chicago;Dallas;Oakland
68200;59700;31;32;1;1;1;0;0;0
66300;72500;33;35;1;2;1;0;0;0
48000;113000;18;62;1;44;1;0;0;0
48000;60000;22;30;1;8;1;0;0;0
60000;69500;27;36;1;9;1;0;0;0
85000;132000;30;53;1;23;1;0;0;0
34500;65000;6;30;1;24;1;0;0;0
61000;69500;33;47;1;14;1;0;0;0
49900;61000;45;52;1;7;1;0;0;0
44500;79000;23;54;1;31;1;0;0;0
24500;47000;24;54;1;30;1;0;0;0
41500;67500;28;48;1;20;1;0;0;0
50000;55000;33;46;1;13;1;0;0;0
28000;38000;12;21;1;9;1;0;0;0
59300;92900;26;39;1;13;1;0;0;0
98900;123000;28;45;1;17;1;0;0;0
20000;32000;30;53;1;23;1;0;0;0
57000;76000;29;35;1;6;1;0;0;0
18000;33400;20;56;1;36;1;0;0;0
62500;92500;26;34;1;8;1;0;0;0
36500;58500;12;30;1;18;1;0;0;0
26900;67500;7;54;1;47;1;0;0;0
28000;38000;33;40;1;7;1;0;0;0
59700;57000;16;17;1;1;1;0;0;0
20500;31500;16;31;1;15;1;0;0;0
69600;63500;22;23;1;1;1;0;0;0
35000;38500;6;7;1;1;1;0;0;0
88300;116500;23;30;1;7;1;0;0;0
36700;56000;21;37;1;16;1;0;0;0
106500;127800;31;34;1;3;1;0;0;0
23000;29000;39;40;1;1;1;0;0;0
43000;59400;25;55;1;30;1;0;0;0
59000;59000;33;34;1;1;1;0;0;0
44000;41000;15;28;1;13;1;0;0;0
43000;63500;9;22;1;13;1;0;0;0
33700;31200;27;29;1;2;1;0;0;0
39200;44000;34;38;1;4;1;0;0;0
32000;46500;25;37;1;12;1;0;0;0
17500;32500;7;38;1;31;1;0;0;0
30000;38500;28;36;1;8;1;0;0;0
59500;82000;60;65;1;5;1;0;0;0
42400;114900;12;64;1;52;1;0;0;0
44600;61500;13;26;1;13;1;0;0;0
33000;59500;5;33;1;28;1;0;0;0
50000;51500;34;48;1;14;1;0;0;0
23500;45500;6;10;1;4;1;0;0;0
38500;60000;23;42;1;19;1;0;0;0
35500;66900;17;37;1;20;1;0;0;0
55000;55000;57;61;1;4;1;0;0;0
50000;70500;26;38;1;12;1;0;0;0
42500;96400;14;63;1;49;1;0;0;0
42200;43000;27;30;1;3;1;0;0;0
23000;33000;1;19;1;18;1;0;0;0
60000;116500;22;54;1;32;1;0;0;0
38000;60000;9;25;1;16;1;0;0;0
23400;47900;14;34;1;20;1;0;0;0
32500;73000;6;37;1;31;1;0;0;0
44700;135000;8;62;1;54;1;0;0;0
64000;67900;21;23;1;2;1;0;0;0
40900;47900;22;29;1;7;1;0;0;0
40400;49000;34;43;1;9;1;0;0;0
105000;140000;29;46;1;17;1;0;0;0
44500;59000;14;24;1;10;1;0;0;0
24000;61000;11;37;1;26;1;0;0;0
63000;53200;60;62;1;2;1;0;0;0
35000;60000;4;28;1;24;1;0;0;0
34500;65000;9;36;1;27;1;0;0;0
45000;45200;57;58;1;1;1;0;0;0
90500;93100;61;63;1;2;1;0;0;0
23000;44900;22;35;1;13;1;0;0;0
22400;41000;3;43;1;40;1;0;0;0
62000;57500;63;64;1;1;1;0;0;0
20000;24000;3;17;1;14;1;0;0;0
29700;29500;9;14;1;5;1;0;0;0
46000;55000;30;32;1;2;1;0;0;0
30000;41500;5;28;1;23;1;0;0;0
35000;86500;11;42;1;31;1;0;0;0
19000;34500;23;46;1;23;1;0;0;0
64900;90300;61;65;1;4;1;0;0;0
60500;90500;29;63;1;34;1;0;0;0
15500;43500;2;62;1;60;1;0;0;0
59500;59500;25;26;1;1;1;0;0;0
42900;61000;26;53;1;27;1;0;0;0
36500;49000;10;19;1;9;1;0;0;0
56400;64900;35;57;1;22;1;0;0;0
41500;42500;34;37;1;3;1;0;0;0
38000;53500;18;30;1;12;1;0;0;0
55000;57000;43;46;1;3;1;0;0;0
34000;52000;9;29;1;20;1;0;0;0
51500;56900;30;52;1;22;1;0;0;0
48000;61000;20;27;1;7;1;0;0;0
18000;33500;19;62;1;43;1;0;0;0
38500;57500;18;32;1;14;1;0;0;0
49900;62900;28;34;1;6;1;0;0;0
54000;82000;26;45;1;19;1;0;0;0
18800;47300;9;43;1;34;1;0;0;0
101000;101700;35;38;1;3;1;0;0;0
50000;100000;9;59;1;50;1;0;0;0
89000;110000;32;51;1;19;1;0;0;0
50000;55000;2;7;1;5;1;0;0;0
32000;63500;19;64;1;45;1;0;0;0
48000;65000;15;29;1;14;1;0;0;0
38000;36500;2;6;1;4;1;0;0;0
29500;59900;3;54;1;51;1;0;0;0
35500;68000;13;50;1;37;1;0;0;0
57900;66000;20;26;1;6;1;0;0;0
27500;28900;12;17;1;5;1;0;0;0
63900;98500;18;51;1;33;1;0;0;0
53500;78500;24;31;1;7;1;0;0;0
24500;69000;14;46;1;32;1;0;0;0
41300;91000;6;38;1;32;1;0;0;0
34000;80500;10;55;1;45;1;0;0;0
56500;63500;37;50;1;13;1;0;0;0
29900;39000;27;35;1;8;1;0;0;0
39800;52900;21;33;1;12;1;0;0;0
39700;54000;36;43;1;7;1;0;0;0
60600;94000;15;33;1;18;1;0;0;0
37500;75000;3;32;1;29;1;0;0;0
43000;43000;22;23;1;1;1;0;0;0
23500;27000;25;28;1;3;1;0;0;0
29800;54000;7;31;1;24;1;0;0;0
39000;46500;34;54;1;20;1;0;0;0
31000;85000;30;40;1;10;1;0;0;0
22800;32900;1;29;1;28;1;0;0;0
28000;41000;28;33;1;5;1;0;0;0
52500;65500;27;47;1;20;1;0;0;0
37500;62900;30;43;1;13;1;0;0;0
39000;42900;36;38;1;2;1;0;0;0
27000;40000;29;59;1;30;1;0;0;0
30500;39900;8;27;1;19;1;0;0;0
47000;60000;31;50;1;19;1;0;0;0
39000;39000;56;60;1;4;1;0;0;0
85700;76500;35;44;1;9;1;0;0;0
48000;69000;27;61;1;34;1;0;0;0
110000;113000;39;55;1;16;1;0;0;0
62000;76000;30;45;1;15;1;0;0;0
27000;55200;4;32;1;28;1;0;0;0
45000;142000;20;62;1;42;1;0;0;0
39200;54000;6;19;1;13;1;0;0;0
30500;44000;12;22;1;10;1;0;0;0
31900;54000;29;38;1;9;1;0;0;0
35900;73000;20;49;1;29;1;0;0;0
25900;29000;16;23;1;7;1;0;0;0
45900;72000;18;45;1;27;1;0;0;0
80500;84000;34;43;1;9;1;0;0;0
89000;175000;31;63;1;32;1;0;0;0
49500;49700;30;32;1;2;1;0;0;0
85500;109500;35;63;1;28;1;0;0;0
81300;78600;44;45;1;1;1;0;0;0
85000;82500;44;51;1;7;1;0;0;0
27200;49500;6;30;1;24;1;0;0;0
45000;115000;2;39;1;37;1;0;0;0
38500;50900;28;33;1;5;1;0;0;0
27000;39000;15;35;1;20;1;0;0;0
44300;81500;7;27;1;20;1;0;0;0
63000;67000;39;53;1;14;1;0;0;0
33000;47000;25;34;1;9;1;0;0;0
71000;74000;46;56;1;10;1;0;0;0
36000;43000;27;33;1;6;1;0;0;0
67500;65000;39;49;1;10;1;0;0;0
28700;30000;11;13;1;2;1;0;0;0
49900;56000;45;46;1;1;1;0;0;0
68000;93000;25;32;1;7;1;0;0;0
98800;98800;63;65;1;2;1;0;0;0
36000;36000;21;25;1;4;1;0;0;0
58000;57000;54;56;1;2;1;0;0;0
53500;67700;38;45;1;7;1;0;0;0
94200;147000;21;31;1;10;1;0;0;0
48000;62000;23;32;1;9;1;0;0;0
53300;71900;29;54;1;25;1;0;0;0
41900;48000;36;43;1;7;1;0;0;0
19000;29000;19;38;1;19;1;0;0;0
48000;41000;26;30;1;4;1;0;0;0
39000;46200;6;14;1;8;1;0;0;0
75500;76900;56;58;1;2;1;0;0;0
25300;61900;6;54;1;48;1;0;0;0
24500;28300;8;11;1;3;1;0;0;0
56900;57000;28;29;1;1;1;0;0;0
32500;62000;7;37;1;30;1;0;0;0
32500;50100;28;44;1;16;1;0;0;0
122500;139500;39;54;1;15;1;0;0;0
30500;31500;7;9;1;2;1;0;0;0
34400;56500;34;55;1;21;1;0;0;0
25000;30500;21;33;1;12;1;0;0;0
57000;79000;32;47;1;15;1;0;0;0
118000;144500;32;46;1;14;1;0;0;0
47400;68000;29;47;1;18;1;0;0;0
33400;50000;9;57;1;48;1;0;0;0
65000;52200;25;28;1;3;1;0;0;0
69800;70500;32;44;1;12;1;0;0;0
30000;31000;12;15;1;3;1;0;0;0
72000;72000;58;59;1;1;1;0;0;0
58900;81900;29;56;1;27;1;0;0;0
34000;70000;26;38;1;12;1;0;0;0
34000;62000;5;30;1;25;1;0;0;0
25000;33500;7;29;1;22;1;0;0;0
69500;91900;27;51;1;24;1;0;0;0
28500;28500;8;9;1;1;1;0;0;0
60000;103000;24;39;1;15;1;0;0;0
90000;90000;58;62;1;4;1;0;0;0
56900;62000;35;51;1;16;1;0;0;0
65900;70900;53;64;1;11;1;0;0;0
49000;52000;36;59;1;23;1;0;0;0
56000;65000;26;30;1;4;1;0;0;0
83000;104500;36;62;1;26;1;0;0;0
108500;94500;63;64;1;1;1;0;0;0
37600;50000;6;22;1;16;1;0;0;0
25000;56000;6;38;1;32;1;0;0;0
53000;78000;23;35;1;12;1;0;0;0
27500;29500;7;9;1;2;1;0;0;0
27000;51500;5;22;1;17;1;0;0;0
68000;74000;39;51;1;12;1;0;0;0
24100;40000;9;35;1;26;1;0;0;0
80500;86900;42;56;1;14;1;0;0;0
42500;48500;14;23;1;9;1;0;0;0
24500;24500;10;11;1;1;1;0;0;0
62000;77000;36;50;1;14;1;0;0;0
70900;87500;33;43;1;10;1;0;0;0
19000;35000;12;46;1;34;1;0;0;0
15300;30000;4;60;1;56;1;0;0;0
64000;68500;56;61;1;5;1;0;0;0
27500;33500;11;25;1;14;1;0;0;0
20500;24000;3;29;1;26;1;0;0;0
31400;33000;8;27;1;19;1;0;0;0
35000;37900;8;10;1;2;1;0;0;0
28500;40000;12;26;1;14;1;0;0;0
25500;55000;23;36;1;13;1;0;0;0
67000;74900;31;36;1;5;1;0;0;0
31500;53900;9;27;1;18;1;0;0;0
23900;36000;30;53;1;23;1;0;0;0
68000;74900;31;33;1;2;1;0;0;0
69000;71500;36;47;1;11;1;0;0;0
77500;82500;31;54;1;23;1;0;0;0
22400;30000;11;35;1;24;1;0;0;0
23500;24900;12;14;1;2;1;0;0;0
31500;56500;9;53;1;44;1;0;0;0
157000;184000;39;55;1;16;1;0;0;0
33500;45000;20;29;1;9;1;0;0;0
23900;35000;12;30;1;18;1;0;0;0
15300;16900;5;25;1;20;1;0;0;0
37100;58500;18;31;1;13;1;0;0;0
65000;119500;24;65;1;41;1;0;0;0
78000;136000;27;58;1;31;1;0;0;0
32500;52000;31;48;1;17;1;0;0;0
63500;67900;37;44;1;7;1;0;0;0
52000;74000;22;34;1;12;1;0;0;0
48500;51000;34;46;1;12;1;0;0;0
47000;80600;22;38;1;16;1;0;0;0
18000;42000;20;47;1;27;1;0;0;0
69400;69000;37;45;1;8;1;0;0;0
43500;49900;36;45;1;9;1;0;0;0
31500;38200;11;13;1;2;1;0;0;0
23700;25500;6;9;1;3;1;0;0;0
26000;52000;10;43;1;33;1;0;0;0
48900;63000;36;37;1;1;1;0;0;0
33000;49000;6;27;1;21;1;0;0;0
30000;32500;33;38;1;5;1;0;0;0
27500;26000;28;32;1;4;1;0;0;0
60400;75800;30;38;1;8;1;0;0;0
31800;31300;6;7;1;1;1;0;0;0
44000;55000;15;26;1;11;1;0;0;0
30000;57500;5;36;1;31;1;0;0;0
26500;32000;10;17;1;7;1;0;0;0
16500;23000;5;16;1;11;1;0;0;0
87500;84200;63;64;1;1;1;0;0;0
40000;47500;21;30;1;9;1;0;0;0
61000;69000;25;29;1;4;1;0;0;0
41000;116000;12;59;1;47;1;0;0;0
57900;67900;31;33;1;2;1;0;0;0
25000;28900;17;30;1;13;1;0;0;0
23000;24500;29;30;1;1;1;0;0;0
38500;76000;11;46;1;35;1;0;0;0
85000;141000;16;22;1;6;1;0;0;0
121800;147000;35;55;1;20;1;0;0;0
93500;115000;33;37;1;4;1;0;0;0
35000;39000;59;64;1;5;1;0;0;0
26500;35000;38;48;1;10;1;0;0;0
25000;32000;8;13;1;5;1;0;0;0
51400;61000;27;32;1;5;1;0;0;0
69800;68500;53;57;1;4;1;0;0;0
49500;71100;26;53;1;27;1;0;0;0
52500;87000;29;46;1;17;1;0;0;0
24800;62900;3;46;1;43;1;0;0;0
58700;84600;25;53;1;28;1;0;0;0
28500;55000;20;66;1;46;1;0;0;0
75000;76000;38;46;1;8;1;0;0;0
28200;34000;13;31;1;18;1;0;0;0
85000;104000;33;47;1;14;1;0;0;0
39900;60000;26;47;1;21;1;0;0;0
69500;67000;39;54;1;15;1;0;0;0
96000;96000;43;50;1;7;1;0;0;0
50500;61500;21;29;1;8;1;0;0;0
21500;52000;6;34;1;28;1;0;0;0
85500;89500;24;25;1;1;1;0;0;0
12800;26500;14;34;1;20;1;0;0;0
31500;31500;47;55;1;8;1;0;0;0
50000;52500;33;36;1;3;1;0;0;0
28000;29500;14;23;1;9;1;0;0;0
43000;63500;13;30;1;17;1;0;0;0
36500;62000;12;33;1;21;1;0;0;0
29500;63500;32;38;1;6;1;0;0;0
44000;94000;22;63;1;41;1;0;0;0
74000;77500;40;50;1;10;1;0;0;0
40000;52000;31;57;1;26;1;0;0;0
26000;43000;10;23;1;13;1;0;0;0
54500;73900;30;58;1;28;1;0;0;0
26900;64000;10;38;1;28;1;0;0;0
21000;42000;21;37;1;16;1;0;0;0
21600;26000;30;34;1;4;1;0;0;0
40000;58000;25;51;1;26;1;0;0;0
35500;36600;2;6;1;4;1;0;0;0
62500;77500;25;30;1;5;1;0;0;0
68500;85000;34;54;1;20;1;0;0;0
51000;54900;38;39;1;1;1;0;0;0
32000;42500;19;31;1;12;1;0;0;0
51500;63900;26;32;1;6;1;0;0;0
38500;77500;7;55;1;48;1;0;0;0
36900;40000;34;53;1;19;1;0;0;0
55000;102000;17;53;1;36;1;0;0;0
16500;19000;28;31;1;3;1;0;0;0
42300;74000;5;30;1;25;1;0;0;0
18700;28500;13;27;1;14;1;0;0;0
68500;59000;27;33;1;6;1;0;0;0
55500;78000;31;54;1;23;1;0;0;0
32800;43000;30;53;1;23;1;0;0;0
54000;52500;32;33;1;1;1;0;0;0
34200;47500;5;18;1;13;1;0;0;0
62000;69900;33;46;1;13;1;0;0;0
40000;49000;18;23;1;5;1;0;0;0
31300;56400;10;28;1;18;1;0;0;0
20000;34300;30;58;1;28;1;0;0;0
123000;113000;38;43;1;5;1;0;0;0
20000;15500;17;31;1;14;1;0;0;0
40500;68000;14;30;1;16;1;0;0;0
14500;23500;31;43;1;12;1;0;0;0
21000;28900;5;12;1;7;1;0;0;0
27900;50000;13;46;1;33;1;0;0;0
40000;47300;32;36;1;4;1;0;0;0
49000;72500;21;29;1;8;1;0;0;0
25300;30500;7;26;1;19;1;0;0;0
38000;36800;37;49;1;12;1;0;0;0
37000;41000;16;22;1;6;1;0;0;0
15500;28000;20;53;1;33;1;0;0;0
30000;44800;25;33;1;8;1;0;0;0
23000;60500;17;38;1;21;1;0;0;0
39300;52900;7;14;1;7;1;0;0;0
30800;33900;8;14;1;6;1;0;0;0
55000;58900;21;27;1;6;1;0;0;0
31900;48000;12;32;1;20;1;0;0;0
72000;82500;32;48;1;16;1;0;0;0
45500;74000;25;54;1;29;1;0;0;0
40000;59500;31;46;1;15;1;0;0;0
21000;40000;18;47;1;29;1;0;0;0
53900;68500;28;37;1;9;1;0;0;0
17800;37000;12;54;1;42;1;0;0;0
29500;35600;12;18;1;6;1;0;0;0
30500;29000;38;39;1;1;1;0;0;0
60500;59700;38;46;1;8;1;0;0;0
22000;32500;6;22;1;16;1;0;0;0
38700;72200;17;38;1;21;1;0;0;0
48000;48400;40;44;1;4;1;0;0;0
52700;104000;16;39;1;23;1;0;0;0
72700;76200;59;64;1;5;1;0;0;0
18100;30000;22;38;1;16;1;0;0;0
119000;124500;32;43;1;11;1;0;0;0
40000;56000;27;35;1;8;1;0;0;0
29500;47500;28;58;1;30;1;0;0;0
50000;116000;20;65;1;45;1;0;0;0
33500;47000;15;28;1;13;1;0;0;0
35000;53000;23;37;1;14;1;0;0;0
56000;56000;3;10;1;7;1;0;0;0
34000;66000;17;54;1;37;1;0;0;0
37900;37900;9;10;1;1;1;0;0;0
27500;43900;9;28;1;19;1;0;0;0
53000;67900;28;35;1;7;1;0;0;0
83500;103500;12;18;1;6;1;0;0;0
42000;95000;14;44;1;30;1;0;0;0
42800;81500;10;31;1;21;1;0;0;0
27900;36800;14;32;1;18;1;0;0;0
39000;66000;25;49;1;24;1;0;0;0
32500;47500;10;21;1;11;1;0;0;0
17900;20000;11;30;1;19;1;0;0;0
43000;60000;60;63;1;3;1;0;0;0
32500;52500;26;38;1;12;1;0;0;0
97600;102000;51;64;1;13;1;0;0;0
22100;22000;11;12;1;1;1;0;0;0
33500;63900;15;37;1;22;1;0;0;0
51900;53900;43;49;1;6;1;0;0;0
29500;59000;3;37;1;34;1;0;0;0
21500;33000;5;26;1;21;1;0;0;0
35000;54000;15;32;1;17;1;0;0;0
56000;81500;23;35;1;12;1;0;0;0
33500;45000;37;50;1;13;1;0;0;0
29500;43300;6;23;1;17;1;0;0;0
61000;76000;30;53;1;23;1;0;0;0
51500;55900;25;30;1;5;1;0;0;0
20700;29000;2;25;1;23;1;0;0;0
21900;40000;13;48;1;35;1;0;0;0
54000;54000;57;60;1;3;1;0;0;0
40500;59900;20;31;1;11;1;0;0;0
83000;76500;53;55;1;2;1;0;0;0
28000;28000;56;58;1;2;1;0;0;0
23000;53000;10;64;1;54;1;0;0;0
30000;27500;44;46;1;2;1;0;0;0
54100;90500;15;33;1;18;1;0;0;0
83500;109000;11;26;1;15;1;0;0;0
53900;62000;21;27;1;6;1;0;0;0
17500;40000;26;44;1;18;1;0;0;0
44900;55500;33;44;1;11;1;0;0;0
52500;86000;25;61;1;36;1;0;0;0
35500;54000;28;43;1;15;1;0;0;0
29000;87000;9;63;1;54;1;0;0;0
54500;138000;8;46;1;38;1;0;0;0
24600;43500;19;57;1;38;1;0;0;0
42500;44500;13;14;1;1;1;0;0;0
52500;62000;23;27;1;4;1;0;0;0
30000;73000;23;53;1;30;1;0;0;0
46500;63900;22;31;1;9;1;0;0;0
27000;37000;31;63;1;32;1;0;0;0
28000;70000;12;30;1;18;1;0;0;0
33000;74500;10;53;1;43;1;0;0;0
66400;66400;63;65;1;2;1;0;0;0
46000;64000;24;34;1;10;1;0;0;0
46200;63000;22;33;1;11;1;0;0;0
38700;62000;26;38;1;12;1;0;0;0
28000;34900;26;34;1;8;1;0;0;0
91000;93500;33;39;1;6;1;0;0;0
50900;81000;23;36;1;13;1;0;0;0
48500;71400;24;37;1;13;1;0;0;0
76000;109000;32;37;1;5;1;0;0;0
33000;58000;27;39;1;12;1;0;0;0
38300;46000;15;23;1;8;1;0;0;0
19500;48000;7;57;1;50;1;0;0;0
35000;36500;22;28;1;6;1;0;0;0
24000;25900;14;17;1;3;1;0;0;0
120500;125600;58;59;1;1;1;0;0;0
28400;46000;18;30;1;12;1;0;0;0
50000;51000;31;32;1;1;1;0;0;0
23500;55000;14;63;1;49;1;0;0;0
21200;29000;14;25;1;11;1;0;0;0
99500;102000;35;38;1;3;1;0;0;0
23900;28100;17;26;1;9;1;0;0;0
18000;33500;2;33;1;31;1;0;0;0
36500;47500;21;33;1;12;1;0;0;0
57000;68500;25;31;1;6;1;0;0;0
39500;42500;7;14;1;7;1;0;0;0
78900;170000;12;43;1;31;1;0;0;0
34000;33000;62;64;1;2;1;0;0;0
83000;92000;34;60;1;26;1;0;0;0
19500;46000;35;40;1;5;1;0;0;0
48000;60000;13;25;1;12;1;0;0;0
182500;208000;34;47;1;13;1;0;0;0
30500;41500;28;35;1;7;1;0;0;0
44000;62000;30;35;1;5;1;0;0;0
36500;39500;14;16;1;2;1;0;0;0
33500;46000;6;19;1;13;1;0;0;0
24600;45000;12;56;1;44;1;0;0;0
104000;106000;36;51;1;15;1;0;0;0
50500;65000;29;59;1;30;1;0;0;0
35700;72000;6;30;1;24;1;0;0;0
19900;28000;26;35;1;9;1;0;0;0
31500;43900;4;14;1;10;1;0;0;0
94500;66900;45;46;1;1;1;0;0;0
16000;21500;2;23;1;21;1;0;0;0
47700;69900;23;43;1;20;1;0;0;0
62500;93200;24;51;1;27;1;0;0;0
42000;55500;29;32;1;3;1;0;0;0
29200;56000;10;38;1;28;1;0;0;0
17500;29000;29;38;1;9;1;0;0;0
34000;35500;34;35;1;1;1;0;0;0
24900;25900;16;17;1;1;1;0;0;0
115000;139500;38;54;1;16;1;0;0;0
92500;100000;22;26;1;4;1;0;0;0
22500;51000;4;39;1;35;1;0;0;0
83000;95000;36;60;1;24;1;0;0;0
26000;46500;12;62;1;50;1;0;0;0
43100;42000;19;28;1;9;1;0;0;0
57000;67500;33;44;1;11;1;0;0;0
55500;64900;26;31;1;5;1;0;0;0
29200;74000;6;52;1;46;1;0;0;0
23500;42500;21;38;1;17;1;0;0;0
83000;83000;34;35;1;1;1;0;0;0
47000;53500;9;14;1;5;1;0;0;0
67000;90000;26;45;1;19;1;0;0;0
53500;55000;39;60;1;21;1;0;0;0
74300;78000;36;57;1;21;1;0;0;0
27000;28000;11;12;1;1;1;0;0;0
29500;28900;3;31;1;28;1;0;0;0
84600;148000;19;39;1;20;1;0;0;0
26900;44000;7;28;1;21;1;0;0;0
24000;28900;24;35;1;11;1;0;0;0
23900;34000;15;27;1;12;1;0;0;0
23000;39000;32;47;1;15;1;0;0;0
64000;67500;19;23;1;4;1;0;0;0
27000;47000;27;47;1;20;1;0;0;0
90000;89100;40;48;1;8;1;0;0;0
73400;76000;60;61;1;1;1;0;0;0
16500;23000;19;35;1;16;1;0;0;0
21000;30000;27;35;1;8;1;0;0;0
64000;79800;31;54;1;23;1;0;0;0
116000;248000;24;45;1;21;1;0;0;0
57500;76500;26;38;1;12;1;0;0;0
24500;27500;11;22;1;11;1;0;0;0
52600;64500;38;53;1;15;1;0;0;0
27300;38900;5;28;1;23;1;0;0;0
85400;122500;26;33;1;7;1;0;0;0
62800;95000;1;17;1;16;1;0;0;0
64200;117000;10;29;1;19;1;0;0;0
40300;43800;12;13;1;1;1;0;0;0
40000;80000;28;53;1;25;1;0;0;0
28000;58500;11;58;1;47;1;0;0;0
69000;69900;63;64;1;1;1;0;0;0
62000;63000;39;53;1;14;1;0;0;0
38500;44900;31;37;1;6;1;0;0;0
115000;126000;32;37;1;5;1;0;0;0
57000;65000;30;34;1;4;1;0;0;0
12000;19400;17;19;1;2;1;0;0;0
56000;56500;34;35;1;1;1;0;0;0
49000;75000;22;33;1;11;1;0;0;0
30000;34500;20;23;1;3;1;0;0;0
49000;63500;19;30;1;11;1;0;0;0
47000;62000;20;33;1;13;1;0;0;0
18500;20500;22;26;1;4;1;0;0;0
65000;110000;4;26;1;22;1;0;0;0
48800;64000;35;52;1;17;1;0;0;0
31000;37500;27;30;1;3;1;0;0;0
58700;63000;15;18;1;3;1;0;0;0
36500;40500;5;12;1;7;1;0;0;0
59500;69500;31;44;1;13;1;0;0;0
31000;65000;18;56;1;38;1;0;0;0
33900;39500;17;26;1;9;1;0;0;0
33500;55000;26;40;1;14;1;0;0;0
38000;92000;11;66;1;55;1;0;0;0
66500;71000;40;47;1;7;1;0;0;0
50500;67000;2;17;1;15;1;0;0;0
71500;88000;30;50;1;20;1;0;0;0
53000;55000;32;45;1;13;1;0;0;0
29500;31000;13;17;1;4;1;0;0;0
32000;49900;26;56;1;30;1;0;0;0
31500;78500;9;56;1;47;1;0;0;0
60000;83000;30;46;1;16;1;0;0;0
26500;58000;23;63;1;40;1;0;0;0
157000;188000;32;42;1;10;1;0;0;0
21900;32900;5;31;1;26;1;0;0;0
22000;24000;2;29;1;27;1;0;0;0
39500;40000;37;45;1;8;1;0;0;0
39900;39900;58;59;1;1;1;0;0;0
50500;120000;5;33;1;28;1;0;0;0
30000;34000;56;57;1;1;1;0;0;0
83000;95000;53;65;1;12;1;0;0;0
32000;54500;14;32;1;18;1;0;0;0
30500;44500;9;25;1;16;1;0;0;0
49500;54000;11;16;1;5;1;0;0;0
46000;71000;24;43;1;19;1;0;0;0
45900;46200;12;13;1;1;1;0;0;0
48500;85000;11;57;1;46;1;0;0;0
40000;44600;14;18;1;4;1;0;0;0
41000;43000;22;28;1;6;1;0;0;0
31500;68500;9;39;1;30;1;0;0;0
36500;60900;28;51;1;23;1;0;0;0
29900;28000;38;39;1;1;1;0;0;0
36000;55000;30;39;1;9;1;0;0;0
30400;50000;7;32;1;25;1;0;0;0
27500;40500;12;31;1;19;1;0;0;0
23500;35900;14;34;1;20;1;0;0;0
29000;49000;36;55;1;19;1;0;0;0
65500;72200;3;13;1;10;1;0;0;0
43000;59500;30;37;1;7;1;0;0;0
33500;79000;13;49;1;36;1;0;0;0
75000;86500;57;65;1;8;1;0;0;0
31100;44200;14;25;1;11;1;0;0;0
59000;95000;6;26;1;20;1;0;0;0
103500;143500;25;33;1;8;1;0;0;0
67500;82000;6;18;1;12;1;0;0;0
27200;28900;3;5;1;2;1;0;0;0
29000;33300;17;22;1;5;1;0;0;0
18000;53000;2;55;1;53;1;0;0;0
44000;83000;29;65;1;36;1;0;0;0
54900;100500;10;38;1;28;1;0;0;0
34500;42000;3;14;1;11;1;0;0;0
70000;83000;35;37;1;2;1;0;0;0
33500;62000;26;66;1;40;1;0;0;0
30000;28500;37;38;1;1;1;0;0;0
49700;68000;30;49;1;19;1;0;0;0
34500;34500;28;33;1;5;1;0;0;0
46600;87000;13;36;1;23;1;0;0;0
29000;40000;17;27;1;10;1;0;0;0
48500;57000;6;16;1;10;1;0;0;0
43000;47000;21;25;1;4;1;0;0;0
21500;68500;9;35;1;26;1;0;0;0
66500;67000;60;62;1;2;1;0;0;0
56000;62500;35;58;1;23;1;0;0;0
64400;79700;29;36;1;7;1;0;0;0
58000;62900;35;54;1;19;1;0;0;0
20500;24500;13;29;1;16;1;0;0;0
76700;86000;30;51;1;21;1;0;0;0
26400;59000;14;22;1;8;1;0;0;0
29500;51000;8;27;1;19;1;0;0;0
26500;51900;9;36;1;27;1;0;0;0
25500;39500;24;57;1;33;1;0;0;0
74000;84000;31;54;1;23;1;0;0;0
28900;56900;13;56;1;43;1;0;0;0
44000;49200;31;35;1;4;1;0;0;0
49500;32900;17;20;1;3;1;0;0;0
23500;37000;30;51;1;21;1;0;0;0
41400;55000;30;35;1;5;1;0;0;0
87500;114000;31;50;1;19;1;0;0;0
27700;32000;1;22;1;21;1;0;0;0
55500;76000;21;33;1;12;1;0;0;0
27000;59000;11;53;1;42;1;0;0;0
41000;53500;33;55;1;22;1;0;0;0
27900;27900;34;39;1;5;1;0;0;0
52500;59000;20;25;1;5;1;0;0;0
32500;38000;14;26;1;12;1;0;0;0
31000;37500;2;33;1;31;1;0;0;0
28200;53000;2;31;1;29;1;0;0;0
24400;33500;12;26;1;14;1;0;0;0
38500;81000;12;39;1;27;1;0;0;0
38500;54900;10;23;1;13;1;0;0;0
63700;86000;28;39;1;11;1;0;0;0
60000;82900;28;32;1;4;1;0;0;0
69000;83000;30;35;1;5;1;0;0;0
31400;30600;13;14;1;1;1;0;0;0
35000;38000;8;13;1;5;1;0;0;0
32000;33500;21;25;1;4;1;0;0;0
27900;53000;11;35;1;24;1;0;0;0
113000;119900;36;49;1;13;1;0;0;0
112000;149000;27;35;1;8;1;0;0;0
18500;39000;14;55;1;41;1;0;0;0
34000;64500;13;39;1;26;1;0;0;0
47500;70600;22;43;1;21;1;0;0;0
49000;67900;3;18;1;15;1;0;0;0
49900;50700;1;7;1;6;1;0;0;0
85500;120000;26;38;1;12;1;0;0;0
78000;76000;35;49;1;14;1;0;0;0
31500;34000;37;39;1;2;1;0;0;0
42000;64000;27;54;1;27;1;0;0;0
40000;79500;13;61;1;48;1;0;0;0
21500;27500;17;26;1;9;1;0;0;0
27500;36400;2;14;1;12;1;0;0;0
15500;18300;6;28;1;22;1;0;0;0
35000;45800;12;19;1;7;1;0;0;0
59000;64000;13;23;1;10;1;0;0;0
41500;49900;35;37;1;2;1;0;0;0
41900;54000;10;25;1;15;1;0;0;0
30500;36500;25;32;1;7;1;0;0;0
37400;51000;18;31;1;13;1;0;0;0
30000;45000;32;38;1;6;1;0;0;0
52000;129000;2;48;1;46;1;0;0;0
36000;36500;22;23;1;1;1;0;0;0
22500;62900;3;59;1;56;1;0;0;0
80500;83000;36;39;1;3;1;0;0;0
41000;62600;22;34;1;12;1;0;0;0
33500;41500;23;30;1;7;1;0;0;0
30000;43700;13;26;1;13;1;0;0;0
35500;69500;11;54;1;43;1;0;0;0
51500;66500;29;35;1;6;1;0;0;0
54000;62500;17;23;1;6;1;0;0;0
46000;64000;29;61;1;32;1;0;0;0
35000;47500;14;27;1;13;1;0;0;0
59900;59900;59;63;1;4;1;0;0;0
32000;38500;29;31;1;2;1;0;0;0
36500;41500;29;33;1;4;1;0;0;0
31500;48000;38;53;1;15;1;0;0;0
26500;40500;13;24;1;11;1;0;0;0
35000;43000;12;25;1;13;1;0;0;0
24000;46500;23;37;1;14;1;0;0;0
72000;71000;33;52;1;19;1;0;0;0
60000;90900;27;61;1;34;1;0;0;0
25500;32500;27;33;1;6;1;0;0;0
22400;27000;3;26;1;23;1;0;0;0
63900;122000;8;32;1;24;1;0;0;0
37800;37500;3;6;1;3;1;0;0;0
45500;62000;28;35;1;7;1;0;0;0
36500;47000;26;32;1;6;1;0;0;0
65000;167200;6;46;1;40;1;0;0;0
35000;45100;23;31;1;8;1;0;0;0
38100;88000;5;54;1;49;1;0;0;0
44900;63500;19;30;1;11;1;0;0;0
58500;88000;23;35;1;12;1;0;0;0
30400;38000;4;30;1;26;1;0;0;0
63500;73500;15;23;1;8;1;0;0;0
29000;53000;13;34;1;21;1;0;0;0
28000;38000;35;53;1;18;1;0;0;0
34500;44500;5;18;1;13;1;0;0;0
32000;43000;1;14;1;13;1;0;0;0
25000;60000;13;54;1;41;1;0;0;0
34500;54000;27;42;1;15;1;0;0;0
20500;42500;10;56;1;46;1;0;0;0
48500;80000;14;33;1;19;1;0;0;0
36000;40500;11;17;1;6;1;0;0;0
36000;57500;30;55;1;25;1;0;0;0
55100;55500;34;35;1;1;1;0;0;0
25000;57000;26;54;1;28;1;0;0;0
46500;105000;13;64;1;51;1;0;0;0
32500;41500;11;18;1;7;1;0;0;0
37000;57500;26;37;1;11;1;0;0;0
45500;71000;28;35;1;7;1;0;0;0
72000;86800;17;26;1;9;1;0;0;0
81500;136000;23;42;1;19;1;0;0;0
40000;63500;23;35;1;12;1;0;0;0
25000;29000;35;39;1;4;1;0;0;0
40300;48100;10;18;1;8;1;0;0;0
52500;69900;30;44;1;14;1;0;0;0
74000;76000;63;64;1;1;1;0;0;0
17500;27000;21;33;1;12;1;0;0;0
29500;32900;21;29;1;8;1;0;0;0
22500;26900;14;26;1;12;1;0;0;0
57000;54000;55;66;1;11;1;0;0;0
41500;57500;24;37;1;13;1;0;0;0
30400;43900;14;34;1;20;1;0;0;0
122900;140000;33;45;1;12;1;0;0;0
38000;79900;17;54;1;37;1;0;0;0
34500;36500;1;9;1;8;1;0;0;0
36000;51000;28;34;1;6;1;0;0;0
25900;24900;19;26;1;7;1;0;0;0
31500;62000;14;43;1;29;1;0;0;0
33700;67500;5;30;1;25;1;0;0;0
31100;77500;6;60;1;54;1;0;0;0
19900;17900;27;28;1;1;1;0;0;0
28500;54500;14;46;1;32;1;0;0;0
28500;49500;25;55;1;30;1;0;0;0
112000;170000;31;47;1;16;1;0;0;0
20600;31500;9;23;1;14;1;0;0;0
46800;62900;11;25;1;14;1;0;0;0
57000;58000;34;42;1;8;1;0;0;0
57000;77500;23;36;1;13;1;0;0;0
23000;56000;31;37;1;6;1;0;0;0
58500;82000;20;38;1;18;1;0;0;0
35100;57300;20;58;1;38;1;0;0;0
29000;47000;11;26;1;15;1;0;0;0
17300;24000;1;36;1;35;1;0;0;0
33500;42500;26;35;1;9;1;0;0;0
39000;73000;13;35;1;22;1;0;0;0
52000;61000;32;54;1;22;1;0;0;0
44000;62900;17;30;1;13;1;0;0;0
56000;69000;29;37;1;8;1;0;0;0
26300;36000;14;31;1;17;1;0;0;0
60500;81000;26;46;1;20;1;0;0;0
14000;14000;18;19;1;1;1;0;0;0
30000;55900;22;37;1;15;1;0;0;0
58000;81000;27;46;1;19;1;0;0;0
73500;114000;28;61;1;33;1;0;0;0
23800;20700;18;22;1;4;1;0;0;0
23000;36500;31;37;1;6;1;0;0;0
32000;46500;32;39;1;7;1;0;0;0
24000;25000;22;23;1;1;1;0;0;0
27900;35000;23;31;1;8;1;0;0;0
83000;77500;36;46;1;10;1;0;0;0
69000;78500;31;46;1;15;1;0;0;0
60000;70000;9;14;1;5;1;0;0;0
85000;117000;34;55;1;21;1;0;0;0
28500;42300;38;43;1;5;1;0;0;0
33000;33000;57;58;1;1;1;0;0;0
66900;73000;31;54;1;23;1;0;0;0
76500;85000;35;60;1;25;1;0;0;0
40900;43900;32;33;1;1;1;0;0;0
32500;44900;28;56;1;28;1;0;0;0
60000;74900;25;38;1;13;1;0;0;0
109500;116000;42;46;1;4;1;0;0;0
24900;27000;24;31;1;7;1;0;0;0
15000;33900;7;60;1;53;1;0;0;0
39200;57000;8;18;1;10;1;0;0;0
47500;79000;26;64;1;38;1;0;0;0
41000;117500;13;37;1;24;1;0;0;0
47900;58000;19;28;1;9;1;0;0;0
32200;67900;8;58;1;50;1;0;0;0
45000;49000;15;17;1;2;1;0;0;0
34400;48000;10;54;1;44;1;0;0;0
63000;78000;21;31;1;10;1;0;0;0
36000;60000;35;47;1;12;1;0;0;0
41000;53000;14;22;1;8;1;0;0;0
24500;31900;12;21;1;9;1;0;0;0
37700;63000;29;51;1;22;1;0;0;0
26000;24000;25;26;1;1;1;0;0;0
22500;36500;17;34;1;17;1;0;0;0
15900;37900;30;60;1;30;1;0;0;0
23900;24900;12;14;1;2;1;0;0;0
30500;76100;14;47;1;33;1;0;0;0
37000;45000;21;27;1;6;1;0;0;0
55000;59000;36;55;1;19;1;0;0;0
38000;52900;31;57;1;26;1;0;0;0
35500;90800;2;50;1;48;1;0;0;0
34000;36200;9;12;1;3;1;0;0;0
45000;65000;26;45;1;19;1;0;0;0
87000;116500;31;37;1;6;1;0;0;0
32600;51500;16;29;1;13;1;0;0;0
25000;33500;17;31;1;14;1;0;0;0
53500;72000;25;38;1;13;1;0;0;0
114000;114500;60;62;1;2;1;0;0;0
30000;55500;14;36;1;22;1;0;0;0
48000;75000;30;61;1;31;1;0;0;0
24500;31000;8;38;1;30;1;0;0;0
81500;97500;28;53;1;25;1;0;0;0
38000;49000;9;14;1;5;1;0;0;0
17500;42000;13;36;1;23;1;0;0;0
20000;45000;16;33;1;17;1;0;0;0
75000;79500;37;50;1;13;1;0;0;0
42700;45400;22;25;1;3;1;0;0;0
34000;46000;8;18;1;10;1;0;0;0
66000;81000;37;46;1;9;1;0;0;0
42900;74500;16;31;1;15;1;0;0;0
39900;71900;27;46;1;19;1;0;0;0
175000;207000;38;47;1;9;1;0;0;0
68900;79900;13;23;1;10;1;0;0;0
21500;26000;6;14;1;8;1;0;0;0
27500;30000;12;19;1;7;1;0;0;0
30500;36000;39;54;1;15;1;0;0;0
23900;20100;14;15;1;1;1;0;0;0
25900;28000;30;43;1;13;1;0;0;0
26500;40500;11;26;1;15;1;0;0;0
50000;69900;29;54;1;25;1;0;0;0
51000;85000;29;54;1;25;1;0;0;0
42000;68000;23;38;1;15;1;0;0;0
31000;61200;2;32;1;30;1;0;0;0
54500;65000;11;28;1;17;1;0;0;0
60900;59400;29;30;1;1;1;0;0;0
36900;38900;36;37;1;1;1;0;0;0
32500;69000;10;36;1;26;1;0;0;0
158800;185000;43;46;1;3;1;0;0;0
41500;41500;5;9;1;4;1;0;0;0
59000;55000;55;56;1;1;1;0;0;0
34900;59000;7;28;1;21;1;0;0;0
49800;59500;30;34;1;4;1;0;0;0
65000;122500;15;34;1;19;1;0;0;0
65000;87000;32;55;1;23;1;0;0;0
139000;148000;62;64;1;2;1;0;0;0
25000;28000;35;37;1;2;1;0;0;0
27900;39000;13;27;1;14;1;0;0;0
66400;107000;21;37;1;16;1;0;0;0
26500;37000;39;46;1;7;1;0;0;0
22000;44000;10;29;1;19;1;0;0;0
18000;41500;12;47;1;35;1;0;0;0
37500;56000;20;34;1;14;1;0;0;0
25100;40000;11;29;1;18;1;0;0;0
40000;48000;11;15;1;4;1;0;0;0
103500;142000;30;39;1;9;1;0;0;0
50500;65000;25;36;1;11;1;0;0;0
39500;48500;11;13;1;2;1;0;0;0
31400;38000;14;19;1;5;1;0;0;0
35000;54500;3;23;1;20;1;0;0;0
34500;43500;31;36;1;5;1;0;0;0
14000;29500;32;52;1;20;1;0;0;0
52000;54000;63;64;1;1;1;0;0;0
37500;41000;17;24;1;7;1;0;0;0
118700;134100;62;66;1;4;1;0;0;0
73000;71000;46;54;1;8;1;0;0;0
62000;78000;26;31;1;5;1;0;0;0
53000;56900;14;18;1;4;1;0;0;0
65000;64000;35;50;1;15;1;0;0;0
24000;33000;7;26;1;19;1;0;0;0
36000;38900;33;38;1;5;1;0;0;0
47900;66000;29;58;1;29;1;0;0;0
23000;30000;16;23;1;7;1;0;0;0
27500;44500;10;28;1;18;1;0;0;0
47000;54000;18;23;1;5;1;0;0;0
28000;37000;15;39;1;24;1;0;0;0
45700;56100;6;18;1;12;1;0;0;0
25500;31500;12;27;1;15;1;0;0;0
35000;57000;18;29;1;11;1;0;0;0
23400;37500;8;45;1;37;1;0;0;0
36500;60800;37;56;1;19;1;0;0;0
25500;30000;5;25;1;20;1;0;0;0
32000;62000;5;35;1;30;1;0;0;0
41800;36700;35;36;1;1;1;0;0;0
56900;67500;37;39;1;2;1;0;0;0
32000;60500;22;65;1;43;1;0;0;0
18900;29000;2;36;1;34;1;0;0;0
45500;110000;11;34;1;23;1;0;0;0
33000;74000;5;38;1;33;1;0;0;0
79900;91500;34;62;1;28;1;0;0;0
41500;69900;2;27;1;25;1;0;0;0
38500;46100;31;33;1;2;1;0;0;0
43900;46700;16;23;1;7;1;0;0;0
34600;78500;6;36;1;30;1;0;0;0
45500;72000;25;43;1;18;1;0;0;0
19500;28000;22;30;1;8;1;0;0;0
32300;52300;17;34;1;17;1;0;0;0
76500;70000;63;64;1;1;1;0;0;0
70300;81000;33;62;1;29;1;0;0;0
48500;83000;2;26;1;24;1;0;0;0
28000;37000;9;29;1;20;1;0;0;0
29000;35000;7;14;1;7;1;0;0;0
69000;118000;61;62;1;1;1;0;0;0
39500;92000;7;43;1;36;1;0;0;0
32200;32200;2;4;1;2;1;0;0;0
183500;180000;39;43;1;4;1;0;0;0
59800;83000;21;31;1;10;1;0;0;0
28600;40000;7;26;1;19;1;0;0;0
62000;79000;30;36;1;6;1;0;0;0
50000;59800;13;24;1;11;1;0;0;0
72400;85000;56;62;1;6;1;0;0;0
86000;103100;31;43;1;12;1;0;0;0
21500;35000;2;26;1;24;1;0;0;0
47000;63000;29;35;1;6;1;0;0;0
37500;42500;13;24;1;11;1;0;0;0
48500;80000;22;33;1;11;1;0;0;0
8500;23000;9;57;1;48;1;0;0;0
63500;63200;36;38;1;2;1;0;0;0
21900;34900;30;55;1;25;1;0;0;0
76000;211500;4;34;1;30;1;0;0;0
26000;63000;5;34;1;29;1;0;0;0
20900;43900;10;39;1;29;1;0;0;0
32800;53500;6;25;1;19;1;0;0;0
85200;87900;31;49;1;18;1;0;0;0
78000;85000;39;54;1;15;1;0;0;0
55500;61900;36;40;1;4;1;0;0;0
45000;65200;25;36;1;11;1;0;0;0
14000;16900;15;18;1;3;1;0;0;0
57500;125000;6;37;1;31;1;0;0;0
76000;76000;30;31;1;1;1;0;0;0
40000;77000;26;55;1;29;1;0;0;0
52500;74000;24;54;1;30;1;0;0;0
44000;69500;37;59;1;22;1;0;0;0
98400;98400;33;37;1;4;1;0;0;0
32500;54500;9;31;1;22;1;0;0;0
55500;58000;30;32;1;2;1;0;0;0
75500;105000;21;30;1;9;1;0;0;0
59000;81500;27;44;1;17;1;0;0;0
58500;74000;30;44;1;14;1;0;0;0
15100;40000;29;53;1;24;1;0;0;0
19500;32200;14;47;1;33;1;0;0;0
26600;55000;23;47;1;24;1;0;0;0
64000;78500;33;64;1;31;1;0;0;0
43000;48500;33;39;1;6;1;0;0;0
45000;38000;2;5;1;3;1;0;0;0
47500;57500;24;33;1;9;1;0;0;0
54300;58800;7;13;1;6;1;0;0;0
82000;110200;40;53;1;13;1;0;0;0
63500;72000;26;46;1;20;1;0;0;0
28300;37500;27;34;1;7;1;0;0;0
35900;56000;17;38;1;21;1;0;0;0
19000;51000;4;39;1;35;1;0;0;0
24000;26900;14;23;1;9;1;0;0;0
22000;52000;20;49;1;29;1;0;0;0
63500;100000;32;55;1;23;1;0;0;0
29500;46500;9;26;1;17;1;0;0;0
90400;108000;33;43;1;10;1;0;0;0
42000;49000;31;47;1;16;1;0;0;0
70000;83000;35;54;1;19;1;0;0;0
20200;28500;3;11;1;8;1;0;0;0
24500;40000;5;35;1;30;1;0;0;0
29000;28000;11;31;1;20;1;0;0;0
33000;52000;8;30;1;22;1;0;0;0
40900;35000;33;50;1;17;1;0;0;0
47900;57000;25;29;1;4;1;0;0;0
57900;87500;24;34;1;10;1;0;0;0
72000;99000;37;53;1;16;1;0;0;0
45000;49900;40;45;1;5;1;0;0;0
78500;100000;31;48;1;17;1;0;0;0
50000;54900;36;51;1;15;1;0;0;0
25500;26900;11;17;1;6;1;0;0;0
28900;42000;18;30;1;12;1;0;0;0
49000;49000;59;60;1;1;1;0;0;0
38500;54900;28;37;1;9;1;0;0;0
36400;84200;7;63;1;56;1;0;0;0
106500;114500;30;32;1;2;1;0;0;0
54000;71500;30;45;1;15;1;0;0;0
24900;23500;13;14;1;1;1;0;0;0
59500;58900;35;36;1;1;1;0;0;0
36000;49300;34;62;1;28;1;0;0;0
38000;38000;60;64;1;4;1;0;0;0
60500;72000;33;54;1;21;1;0;0;0
45000;78500;18;53;1;35;1;0;0;0
40500;50000;13;23;1;10;1;0;0;0
34900;36700;15;21;1;6;1;0;0;0
55500;58000;34;39;1;5;1;0;0;0
59000;103000;27;47;1;20;1;0;0;0
39500;94900;12;54;1;42;1;0;0;0
32000;48000;17;50;1;33;1;0;0;0
16500;25000;42;49;1;7;1;0;0;0
44400;59000;34;58;1;24;1;0;0;0
33500;55000;17;34;1;17;1;0;0;0
34000;43900;20;26;1;6;1;0;0;0
40000;54000;22;34;1;12;1;0;0;0
19000;34900;17;33;1;16;1;0;0;0
46900;82500;10;29;1;19;1;0;0;0
18300;30000;17;30;1;13;1;0;0;0
29900;50000;14;37;1;23;1;0;0;0
13000;19000;2;15;1;13;1;0;0;0
31500;51000;10;26;1;16;1;0;0;0
42500;49200;33;43;1;10;1;0;0;0
51000;68000;18;27;1;9;1;0;0;0
27000;49000;7;29;1;22;1;0;0;0
14800;10500;4;6;1;2;1;0;0;0
56500;62900;48;55;1;7;1;0;0;0
35500;35000;30;31;1;1;1;0;0;0
39000;78500;20;37;1;17;1;0;0;0
32200;43000;25;35;1;10;1;0;0;0
26100;64000;6;34;1;28;1;0;0;0
45000;122000;1;39;1;38;1;0;0;0
150000;165000;35;54;1;19;1;0;0;0
27300;63500;2;44;1;42;1;0;0;0
42000;57000;29;51;1;22;1;0;0;0
56000;72000;11;21;1;10;1;0;0;0
27500;45000;11;30;1;19;1;0;0;0
35000;57000;6;26;1;20;1;0;0;0
43500;60500;28;56;1;28;1;0;0;0
45500;71500;23;35;1;12;1;0;0;0
25500;33000;14;29;1;15;1;0;0;0
69000;75000;57;63;2;6;0;1;0;0
168050;167000;52;56;2;4;0;1;0;0
61700;106000;30;57;2;27;0;1;0;0
79500;98000;17;38;2;21;0;1;0;0
109900;113500;52;55;2;3;0;1;0;0
69000;77500;48;54;2;6;0;1;0;0
43900;48000;13;21;2;8;0;1;0;0
36000;37900;37;39;2;2;0;1;0;0
28000;40000;21;33;2;12;0;1;0;0
63500;87450;33;63;2;30;0;1;0;0
110750;127000;49;59;2;10;0;1;0;0
69900;93000;38;59;2;21;0;1;0;0
66000;72000;52;55;2;3;0;1;0;0
15900;19500;9;30;2;21;0;1;0;0
27500;29900;44;45;2;1;0;1;0;0
80700;102000;47;66;2;19;0;1;0;0
18500;43870;5;44;2;39;0;1;0;0
85800;96500;52;54;2;2;0;1;0;0
91000;96000;40;43;2;3;0;1;0;0
108500;121000;57;62;2;5;0;1;0;0
73900;83500;39;45;2;6;0;1;0;0
60000;83500;41;60;2;19;0;1;0;0
42900;43950;40;41;2;1;0;1;0;0
100000;102500;50;58;2;8;0;1;0;0
59500;72700;30;39;2;9;0;1;0;0
58900;66000;56;63;2;7;0;1;0;0
69900;86900;38;44;2;6;0;1;0;0
42500;64900;11;39;2;28;0;1;0;0
15400;34000;9;60;2;51;0;1;0;0
62500;95300;39;56;2;17;0;1;0;0
19000;31500;28;44;2;16;0;1;0;0
50200;52000;55;56;2;1;0;1;0;0
72500;115000;18;37;2;19;0;1;0;0
77000;105900;43;60;2;17;0;1;0;0
49500;45000;45;61;2;16;0;1;0;0
157000;179000;51;62;2;11;0;1;0;0
45500;47600;54;60;2;6;0;1;0;0
41900;43900;45;48;2;3;0;1;0;0
59500;71700;17;35;2;18;0;1;0;0
29000;38500;8;30;2;22;0;1;0;0
54000;63000;49;57;2;8;0;1;0;0
58730;64900;54;60;2;6;0;1;0;0
30000;33400;9;30;2;21;0;1;0;0
39900;46500;42;47;2;5;0;1;0;0
58000;62900;17;32;2;15;0;1;0;0
21300;29500;8;32;2;24;0;1;0;0
21900;24500;42;51;2;9;0;1;0;0
98500;300000;17;54;2;37;0;1;0;0
74500;75900;51;52;2;1;0;1;0;0
231200;297000;40;63;2;23;0;1;0;0
90000;126000;56;64;2;8;0;1;0;0
55500;70700;39;58;2;19;0;1;0;0
81900;130000;35;59;2;24;0;1;0;0
22000;35400;34;45;2;11;0;1;0;0
53000;56500;59;64;2;5;0;1;0;0
53500;59900;50;57;2;7;0;1;0;0
18000;24000;29;52;2;23;0;1;0;0
85900;87000;49;57;2;8;0;1;0;0
81000;161500;35;62;2;27;0;1;0;0
15300;20700;6;40;2;34;0;1;0;0
39200;43900;53;61;2;8;0;1;0;0
156500;158000;46;54;2;8;0;1;0;0
80000;115000;26;39;2;13;0;1;0;0
80900;89300;47;53;2;6;0;1;0;0
43500;38900;38;47;2;9;0;1;0;0
39900;79900;32;41;2;9;0;1;0;0
51500;56500;30;41;2;11;0;1;0;0
34500;36700;11;29;2;18;0;1;0;0
60000;50000;60;61;2;1;0;1;0;0
32000;65900;8;39;2;31;0;1;0;0
175000;230000;35;47;2;12;0;1;0;0
54900;94500;26;57;2;31;0;1;0;0
133060;140900;53;57;2;4;0;1;0;0
48500;63500;34;41;2;7;0;1;0;0
129500;188000;40;61;2;21;0;1;0;0
47500;66900;33;39;2;6;0;1;0;0
16000;30000;20;44;2;24;0;1;0;0
110820;120900;61;66;2;5;0;1;0;0
30000;35500;26;40;2;14;0;1;0;0
74000;132000;29;52;2;23;0;1;0;0
99500;100000;59;65;2;6;0;1;0;0
58900;64500;43;54;2;11;0;1;0;0
34200;37500;7;11;2;4;0;1;0;0
38200;40000;9;27;2;18;0;1;0;0
65500;70340;43;45;2;2;0;1;0;0
39000;48250;51;64;2;13;0;1;0;0
61490;67100;46;65;2;19;0;1;0;0
24500;27900;14;35;2;21;0;1;0;0
90000;176200;12;35;2;23;0;1;0;0
41900;66850;32;62;2;30;0;1;0;0
34900;40240;50;53;2;3;0;1;0;0
61000;90500;43;62;2;19;0;1;0;0
93600;114500;40;61;2;21;0;1;0;0
19100;29170;6;44;2;38;0;1;0;0
46400;48900;39;41;2;2;0;1;0;0
27500;51500;15;44;2;29;0;1;0;0
48900;59700;26;44;2;18;0;1;0;0
47500;48900;55;59;2;4;0;1;0;0
53000;88100;25;51;2;26;0;1;0;0
47100;51000;40;43;2;3;0;1;0;0
35000;42750;50;63;2;13;0;1;0;0
89500;110000;44;61;2;17;0;1;0;0
76800;96500;26;38;2;12;0;1;0;0
53800;55000;50;52;2;2;0;1;0;0
65500;72000;18;35;2;17;0;1;0;0
68000;76500;41;56;2;15;0;1;0;0
25000;38000;8;17;2;9;0;1;0;0
122500;153500;34;42;2;8;0;1;0;0
164000;168500;57;60;2;3;0;1;0;0
63900;77500;43;58;2;15;0;1;0;0
35800;59000;36;56;2;20;0;1;0;0
36900;41500;30;40;2;10;0;1;0;0
75000;80000;52;57;2;5;0;1;0;0
50900;45800;39;42;2;3;0;1;0;0
68500;68500;53;54;2;1;0;1;0;0
47000;53900;44;49;2;5;0;1;0;0
169900;177900;60;61;2;1;0;1;0;0
39000;63200;34;54;2;20;0;1;0;0
31500;38500;7;14;2;7;0;1;0;0
70000;86400;38;53;2;15;0;1;0;0
5760;5300;19;24;2;5;0;1;0;0
48000;59500;18;38;2;20;0;1;0;0
104900;119500;46;61;2;15;0;1;0;0
59000;83200;45;63;2;18;0;1;0;0
13600;20500;8;36;2;28;0;1;0;0
32000;65000;12;40;2;28;0;1;0;0
41500;37900;54;65;2;11;0;1;0;0
66900;68500;55;63;2;8;0;1;0;0
149900;180000;50;60;2;10;0;1;0;0
24900;26500;18;25;2;7;0;1;0;0
27400;36900;24;36;2;12;0;1;0;0
45200;93500;15;60;2;45;0;1;0;0
47670;56500;45;56;2;11;0;1;0;0
24000;30000;40;65;2;25;0;1;0;0
5080;4850;28;34;2;6;0;1;0;0
26500;36500;32;50;2;18;0;1;0;0
40200;43600;39;40;2;1;0;1;0;0
46300;54000;39;48;2;9;0;1;0;0
63000;85000;37;62;2;25;0;1;0;0
62300;96500;38;63;2;25;0;1;0;0
42500;69800;37;55;2;18;0;1;0;0
71200;76500;45;54;2;9;0;1;0;0
64000;69000;44;47;2;3;0;1;0;0
120500;111000;48;56;2;8;0;1;0;0
27700;27900;40;66;2;26;0;1;0;0
23900;40000;31;58;2;27;0;1;0;0
17000;33500;16;53;2;37;0;1;0;0
37500;40900;53;59;2;6;0;1;0;0
42700;57000;14;42;2;28;0;1;0;0
75700;107650;39;51;2;12;0;1;0;0
75000;118750;25;57;2;32;0;1;0;0
89900;94900;47;55;2;8;0;1;0;0
59860;62900;43;50;2;7;0;1;0;0
71000;91300;39;54;2;15;0;1;0;0
45000;67700;30;47;2;17;0;1;0;0
43500;75000;32;65;2;33;0;1;0;0
40700;46500;29;31;2;2;0;1;0;0
31900;39300;39;51;2;12;0;1;0;0
25300;33500;7;29;2;22;0;1;0;0
33000;56600;29;52;2;23;0;1;0;0
31800;67000;11;41;2;30;0;1;0;0
89500;89500;62;63;2;1;0;1;0;0
23000;69000;13;66;2;53;0;1;0;0
38300;42800;30;37;2;7;0;1;0;0
30000;38400;13;29;2;16;0;1;0;0
48600;55070;42;43;2;1;0;1;0;0
16500;20000;8;31;2;23;0;1;0;0
99900;118000;43;61;2;18;0;1;0;0
20800;24200;6;32;2;26;0;1;0;0
54200;70000;40;56;2;16;0;1;0;0
45900;61000;39;50;2;11;0;1;0;0
197750;215000;55;56;2;1;0;1;0;0
41500;85000;10;38;2;28;0;1;0;0
42000;62500;22;39;2;17;0;1;0;0
128500;135000;57;63;2;6;0;1;0;0
81900;76800;59;62;2;3;0;1;0;0
29700;33900;5;27;2;22;0;1;0;0
83900;88200;46;53;2;7;0;1;0;0
104800;130000;39;51;2;12;0;1;0;0
50000;97730;26;61;2;35;0;1;0;0
58900;110000;27;63;2;36;0;1;0;0
54900;57500;57;61;2;4;0;1;0;0
47720;46320;43;44;2;1;0;1;0;0
63900;79500;46;57;2;11;0;1;0;0
40000;43900;29;40;2;11;0;1;0;0
53250;54900;61;62;2;1;0;1;0;0
17400;28900;15;46;2;31;0;1;0;0
23400;34000;5;33;2;28;0;1;0;0
84500;110500;43;61;2;18;0;1;0;0
17500;21700;6;32;2;26;0;1;0;0
21900;43000;6;45;2;39;0;1;0;0
73000;81000;23;31;2;8;0;1;0;0
20200;35900;6;30;2;24;0;1;0;0
32000;60000;23;46;2;23;0;1;0;0
31500;36800;6;34;2;28;0;1;0;0
16700;24450;16;50;2;34;0;1;0;0
20000;28000;10;40;2;30;0;1;0;0
150000;198800;22;49;2;27;0;1;0;0
10020;24700;53;57;2;4;0;1;0;0
60000;75000;17;46;2;29;0;1;0;0
83500;89900;61;62;2;1;0;1;0;0
105000;173500;49;54;2;5;0;1;0;0
74000;81900;45;53;2;8;0;1;0;0
56500;59900;43;54;2;11;0;1;0;0
43800;48200;38;47;2;9;0;1;0;0
56000;78000;23;46;2;23;0;1;0;0
24660;36000;50;57;2;7;0;1;0;0
24300;57750;5;57;2;52;0;1;0;0
60000;71500;45;57;2;12;0;1;0;0
135000;145000;54;59;2;5;0;1;0;0
164900;172550;55;57;2;2;0;1;0;0
34500;37200;57;59;2;2;0;1;0;0
43500;71000;9;44;2;35;0;1;0;0
90000;125000;42;53;2;11;0;1;0;0
43900;50000;50;56;2;6;0;1;0;0
70500;74000;38;43;2;5;0;1;0;0
16000;28500;27;46;2;19;0;1;0;0
78900;80750;46;47;2;1;0;1;0;0
78120;76500;49;51;2;2;0;1;0;0
21000;26900;37;45;2;8;0;1;0;0
24700;34000;10;26;2;16;0;1;0;0
25600;49500;30;57;2;27;0;1;0;0
17800;32570;27;45;2;18;0;1;0;0
52000;76000;46;65;2;19;0;1;0;0
36500;46200;19;39;2;20;0;1;0;0
173500;231200;37;40;2;3;0;1;0;0
35000;44200;20;36;2;16;0;1;0;0
20500;23500;7;23;2;16;0;1;0;0
66000;69900;48;53;2;5;0;1;0;0
103900;122000;53;63;2;10;0;1;0;0
53400;68000;38;42;2;4;0;1;0;0
207350;250000;42;50;2;8;0;1;0;0
90900;104500;38;47;2;9;0;1;0;0
27900;36000;35;54;2;19;0;1;0;0
17000;18700;14;30;2;16;0;1;0;0
145000;160000;56;62;2;6;0;1;0;0
37500;51500;11;30;2;19;0;1;0;0
20000;26900;5;34;2;29;0;1;0;0
45500;94000;32;62;2;30;0;1;0;0
41000;59300;10;33;2;23;0;1;0;0
34900;59000;11;52;2;41;0;1;0;0
30400;37000;18;58;2;40;0;1;0;0
110000;162500;38;64;2;26;0;1;0;0
77900;89900;43;51;2;8;0;1;0;0
38000;95000;22;58;2;36;0;1;0;0
41900;47500;39;56;2;17;0;1;0;0
137400;141000;59;61;2;2;0;1;0;0
60000;60000;54;56;2;2;0;1;0;0
23500;29900;10;38;2;28;0;1;0;0
55000;115000;26;63;2;37;0;1;0;0
79400;80250;41;47;2;6;0;1;0;0
25500;67900;12;63;2;51;0;1;0;0
65000;72500;43;54;2;11;0;1;0;0
32500;54900;30;40;2;10;0;1;0;0
50200;52500;43;48;2;5;0;1;0;0
114000;125000;63;65;2;2;0;1;0;0
42000;74000;34;58;2;24;0;1;0;0
32000;36700;31;39;2;8;0;1;0;0
34900;37300;25;37;2;12;0;1;0;0
11000;20650;51;53;2;2;0;1;0;0
48900;52000;44;62;2;18;0;1;0;0
48900;57700;33;45;2;12;0;1;0;0
36800;38000;40;41;2;1;0;1;0;0
19300;24200;12;30;2;18;0;1;0;0
36000;45000;43;54;2;11;0;1;0;0
42200;47000;46;51;2;5;0;1;0;0
61100;85700;37;48;2;11;0;1;0;0
21000;39500;11;56;2;45;0;1;0;0
50000;50000;55;56;2;1;0;1;0;0
60600;69900;41;59;2;18;0;1;0;0
75500;95000;20;38;2;18;0;1;0;0
26400;39500;25;46;2;21;0;1;0;0
20900;30000;28;46;2;18;0;1;0;0
29500;69900;12;54;2;42;0;1;0;0
73900;107000;41;63;2;22;0;1;0;0
27400;55000;23;41;2;18;0;1;0;0
45800;45830;42;51;2;9;0;1;0;0
183900;230000;50;66;2;16;0;1;0;0
76000;83000;43;61;2;18;0;1;0;0
80800;87900;50;61;2;11;0;1;0;0
85000;124500;35;54;2;19;0;1;0;0
55400;55600;48;55;2;7;0;1;0;0
24000;44000;16;45;2;29;0;1;0;0
57500;60000;46;59;2;13;0;1;0;0
34000;41480;40;42;2;2;0;1;0;0
23000;39500;33;60;2;27;0;1;0;0
47000;57750;55;65;2;10;0;1;0;0
216000;273000;55;65;2;10;0;1;0;0
64000;65300;48;53;2;5;0;1;0;0
22800;29500;16;36;2;20;0;1;0;0
74800;90000;40;59;2;19;0;1;0;0
43900;52900;42;51;2;9;0;1;0;0
19200;25000;1;26;2;25;0;1;0;0
56700;86000;34;63;2;29;0;1;0;0
23200;28900;10;26;2;16;0;1;0;0
44570;58900;44;59;2;15;0;1;0;0
120200;134000;58;63;2;5;0;1;0;0
53370;58500;49;51;2;2;0;1;0;0
32000;33000;28;29;2;1;0;1;0;0
86900;104000;43;55;2;12;0;1;0;0
21000;28000;22;35;2;13;0;1;0;0
55400;57500;54;55;2;1;0;1;0;0
23500;48000;10;48;2;38;0;1;0;0
42300;53200;29;47;2;18;0;1;0;0
48500;63500;43;63;2;20;0;1;0;0
37800;56300;35;48;2;13;0;1;0;0
48500;55000;47;54;2;7;0;1;0;0
83000;84550;50;55;2;5;0;1;0;0
55000;61000;42;53;2;11;0;1;0;0
139400;139540;61;62;2;1;0;1;0;0
19000;19500;36;48;2;12;0;1;0;0
36000;53900;43;61;2;18;0;1;0;0
25800;26800;37;38;2;1;0;1;0;0
26800;32000;16;32;2;16;0;1;0;0
25500;30900;18;27;2;9;0;1;0;0
132500;149500;56;63;2;7;0;1;0;0
40000;45500;15;34;2;19;0;1;0;0
72140;76500;53;54;2;1;0;1;0;0
46500;62000;36;41;2;5;0;1;0;0
51400;52900;45;48;2;3;0;1;0;0
26000;27500;46;52;2;6;0;1;0;0
75500;83500;44;48;2;4;0;1;0;0
20000;35000;25;40;2;15;0;1;0;0
48200;78000;31;51;2;20;0;1;0;0
71500;74700;47;50;2;3;0;1;0;0
65900;73000;43;54;2;11;0;1;0;0
26200;31000;5;14;2;9;0;1;0;0
124200;218000;39;57;2;18;0;1;0;0
37500;38500;27;35;2;8;0;1;0;0
72000;79500;59;65;2;6;0;1;0;0
21500;27000;7;17;2;10;0;1;0;0
21000;33800;13;39;2;26;0;1;0;0
52100;54500;30;37;2;7;0;1;0;0
65800;70500;21;31;2;10;0;1;0;0
108000;113900;49;55;2;6;0;1;0;0
24800;37300;20;35;2;15;0;1;0;0
53900;55100;33;37;2;4;0;1;0;0
98500;112500;49;64;2;15;0;1;0;0
189900;217200;56;64;2;8;0;1;0;0
59800;97750;31;54;2;23;0;1;0;0
56200;59000;38;48;2;10;0;1;0;0
119000;138500;46;66;2;20;0;1;0;0
50000;97000;31;51;2;20;0;1;0;0
14200;29000;12;43;2;31;0;1;0;0
73700;97000;37;63;2;26;0;1;0;0
91700;91900;39;40;2;1;0;1;0;0
144500;185000;43;61;2;18;0;1;0;0
36500;53800;29;39;2;10;0;1;0;0
76840;80600;57;64;2;7;0;1;0;0
128700;179000;36;61;2;25;0;1;0;0
102200;102200;55;56;2;1;0;1;0;0
27500;49900;25;62;2;37;0;1;0;0
22500;24100;31;34;2;3;0;1;0;0
174420;174500;51;52;2;1;0;1;0;0
33900;53400;26;39;2;13;0;1;0;0
55200;126000;29;63;2;34;0;1;0;0
63500;89500;27;43;2;16;0;1;0;0
29000;37000;37;42;2;5;0;1;0;0
37400;77450;8;61;2;53;0;1;0;0
36500;46500;9;18;2;9;0;1;0;0
20000;39000;40;55;2;15;0;1;0;0
61000;83500;41;65;2;24;0;1;0;0
68500;81500;33;38;2;5;0;1;0;0
23000;27000;9;31;2;22;0;1;0;0
116000;101000;55;64;2;9;0;1;0;0
43900;47900;48;54;2;6;0;1;0;0
25000;28500;12;26;2;14;0;1;0;0
185000;188000;53;61;2;8;0;1;0;0
94000;114900;54;60;2;6;0;1;0;0
63700;65000;35;36;2;1;0;1;0;0
77200;103500;38;64;2;26;0;1;0;0
53250;54900;61;62;2;1;0;1;0;0
29200;80000;6;57;2;51;0;1;0;0
34500;43800;7;36;2;29;0;1;0;0
19000;28500;7;34;2;27;0;1;0;0
67700;71000;55;60;2;5;0;1;0;0
24500;33400;4;32;2;28;0;1;0;0
60900;82400;37;57;2;20;0;1;0;0
27400;70920;34;54;2;20;0;1;0;0
72900;75000;47;56;2;9;0;1;0;0
57900;68500;43;51;2;8;0;1;0;0
45200;62500;2;16;2;14;0;1;0;0
61900;63900;45;46;2;1;0;1;0;0
79500;79600;44;48;2;4;0;1;0;0
38000;63120;14;65;2;51;0;1;0;0
79500;175000;31;63;2;32;0;1;0;0
26150;30900;46;53;2;7;0;1;0;0
32000;48500;1;20;2;19;0;1;0;0
91000;134500;27;39;2;12;0;1;0;0
56200;64900;58;63;2;5;0;1;0;0
68900;71100;38;39;2;1;0;1;0;0
33500;52250;31;60;2;29;0;1;0;0
37700;43750;39;48;2;9;0;1;0;0
23500;21900;38;49;2;11;0;1;0;0
30400;49900;26;42;2;16;0;1;0;0
87700;124900;43;63;2;20;0;1;0;0
36000;49000;7;31;2;24;0;1;0;0
35900;59000;18;62;2;44;0;1;0;0
34000;58500;45;51;2;6;0;1;0;0
46900;56400;48;62;2;14;0;1;0;0
88000;99000;41;48;2;7;0;1;0;0
30000;31900;28;31;2;3;0;1;0;0
83400;83900;62;63;2;1;0;1;0;0
26900;30900;39;54;2;15;0;1;0;0
47500;52500;14;33;2;19;0;1;0;0
107500;154000;38;46;2;8;0;1;0;0
102500;105150;57;59;2;2;0;1;0;0
66000;89000;43;62;2;19;0;1;0;0
55000;62500;45;54;2;9;0;1;0;0
57000;88500;14;40;2;26;0;1;0;0
51000;88000;34;57;2;23;0;1;0;0
79890;95000;45;60;2;15;0;1;0;0
34700;39700;19;38;2;19;0;1;0;0
23500;45200;35;45;2;10;0;1;0;0
67500;76000;40;60;2;20;0;1;0;0
46050;46270;47;48;2;1;0;1;0;0
47400;50000;22;26;2;4;0;1;0;0
155000;159900;49;55;2;6;0;1;0;0
86400;87400;57;58;2;1;0;1;0;0
45000;75000;9;22;2;13;0;1;0;0
31500;42200;43;59;2;16;0;1;0;0
45170;52150;42;47;2;5;0;1;0;0
42000;50000;46;62;2;16;0;1;0;0
75000;82500;41;45;2;4;0;1;0;0
141400;260000;29;57;2;28;0;1;0;0
46000;66000;11;43;2;32;0;1;0;0
127000;138000;57;65;2;8;0;1;0;0
32500;35500;44;60;2;16;0;1;0;0
48700;92000;12;58;2;46;0;1;0;0
62500;83500;38;62;2;24;0;1;0;0
36000;49350;49;60;2;11;0;1;0;0
36700;44900;39;52;2;13;0;1;0;0
21300;27000;9;31;2;22;0;1;0;0
58700;89920;31;65;2;34;0;1;0;0
24500;30000;14;33;2;19;0;1;0;0
37000;41000;31;41;2;10;0;1;0;0
47900;59000;51;57;2;6;0;1;0;0
43500;56400;13;39;2;26;0;1;0;0
65900;79500;43;52;2;9;0;1;0;0
76800;100000;38;50;2;12;0;1;0;0
26900;38500;36;54;2;18;0;1;0;0
85500;85500;63;65;2;2;0;1;0;0
33900;49500;40;64;2;24;0;1;0;0
83900;87000;41;47;2;6;0;1;0;0
55000;86900;32;60;2;28;0;1;0;0
67900;91000;35;40;2;5;0;1;0;0
31500;36900;47;57;2;10;0;1;0;0
35500;42000;25;37;2;12;0;1;0;0
4990;4900;21;22;2;1;0;1;0;0
23400;61000;38;65;2;27;0;1;0;0
46000;57000;26;38;2;12;0;1;0;0
114700;170000;35;57;2;22;0;1;0;0
24000;40000;34;62;2;28;0;1;0;0
65100;82000;25;43;2;18;0;1;0;0
31500;48600;4;40;2;36;0;1;0;0
19200;23000;31;39;2;8;0;1;0;0
92000;103500;43;52;2;9;0;1;0;0
25000;29900;38;53;2;15;0;1;0;0
71900;87000;39;55;2;16;0;1;0;0
52500;61000;43;58;2;15;0;1;0;0
20700;27500;22;28;2;6;0;1;0;0
16700;27500;30;41;2;11;0;1;0;0
218000;218000;55;56;2;1;0;1;0;0
30500;31000;10;26;2;16;0;1;0;0
92430;110500;54;62;2;8;0;1;0;0
26000;30300;37;39;2;2;0;1;0;0
34000;46500;45;58;2;13;0;1;0;0
5000;5000;22;24;2;2;0;1;0;0
50900;59500;34;40;2;6;0;1;0;0
14500;22000;13;34;2;21;0;1;0;0
142900;170000;54;62;2;8;0;1;0;0
55700;82250;32;49;2;17;0;1;0;0
14100;37600;42;61;2;19;0;1;0;0
30000;32900;15;26;2;11;0;1;0;0
21500;33900;7;40;2;33;0;1;0;0
22500;26900;37;44;2;7;0;1;0;0
33500;36500;46;52;2;6;0;1;0;0
46900;127300;19;65;2;46;0;1;0;0
62000;84500;39;58;2;19;0;1;0;0
39000;44900;39;49;2;10;0;1;0;0
77000;89500;41;55;2;14;0;1;0;0
85000;90250;39;42;2;3;0;1;0;0
69000;80000;38;42;2;4;0;1;0;0
40800;45500;16;24;2;8;0;1;0;0
56500;65000;53;65;2;12;0;1;0;0
35000;63500;14;43;2;29;0;1;0;0
75900;78790;45;57;2;12;0;1;0;0
40500;52750;43;49;2;6;0;1;0;0
71000;105400;40;65;2;25;0;1;0;0
25000;29570;37;48;2;11;0;1;0;0
30500;45500;39;60;2;21;0;1;0;0
78900;98000;44;58;2;14;0;1;0;0
54000;48650;47;48;2;1;0;1;0;0
115340;145000;54;65;2;11;0;1;0;0
17900;28500;4;47;2;43;0;1;0;0
99370;113000;49;61;2;12;0;1;0;0
41700;61500;14;38;2;24;0;1;0;0
60770;73000;47;52;2;5;0;1;0;0
67900;83000;13;30;2;17;0;1;0;0
110000;160000;45;64;2;19;0;1;0;0
72000;73200;38;49;2;11;0;1;0;0
21500;26900;15;34;2;19;0;1;0;0
48900;54500;44;51;2;7;0;1;0;0
114500;120000;55;59;2;4;0;1;0;0
35000;69900;32;57;2;25;0;1;0;0
68200;74500;25;34;2;9;0;1;0;0
16100;24000;35;47;2;12;0;1;0;0
66150;87500;42;65;2;23;0;1;0;0
36000;51000;5;39;2;34;0;1;0;0
66000;94000;30;45;2;15;0;1;0;0
57550;58620;44;52;2;8;0;1;0;0
33400;40200;14;34;2;20;0;1;0;0
189900;205000;48;55;2;7;0;1;0;0
32000;79200;26;54;2;28;0;1;0;0
53400;74500;40;52;2;12;0;1;0;0
47000;52900;31;36;2;5;0;1;0;0
53900;67000;45;57;2;12;0;1;0;0
85400;118000;48;60;2;12;0;1;0;0
54900;61000;14;18;2;4;0;1;0;0
59900;100000;27;61;2;34;0;1;0;0
43700;59900;23;46;2;23;0;1;0;0
68100;73600;45;53;2;8;0;1;0;0
120000;158000;36;45;2;9;0;1;0;0
17200;31900;1;38;2;37;0;1;0;0
15900;26900;11;40;2;29;0;1;0;0
34500;102000;15;39;2;24;0;1;0;0
109900;109900;53;54;2;1;0;1;0;0
12000;17700;5;36;2;31;0;1;0;0
21300;40000;7;51;2;44;0;1;0;0
116000;137500;39;63;2;24;0;1;0;0
83400;95000;51;63;2;12;0;1;0;0
28000;41000;40;59;2;19;0;1;0;0
195850;227990;51;58;2;7;0;1;0;0
76900;106200;42;62;2;20;0;1;0;0
34800;36100;33;34;2;1;0;1;0;0
18100;26500;6;22;2;16;0;1;0;0
55000;65500;38;55;2;17;0;1;0;0
24500;42530;33;51;2;18;0;1;0;0
59900;61900;51;60;2;9;0;1;0;0
83000;89000;64;66;2;2;0;1;0;0
46300;73000;18;57;2;39;0;1;0;0
23500;31100;9;34;2;25;0;1;0;0
17000;27500;45;55;2;10;0;1;0;0
182500;312500;34;53;2;19;0;1;0;0
38500;41400;14;27;2;13;0;1;0;0
42000;47500;30;35;2;5;0;1;0;0
16000;30900;53;54;2;1;0;1;0;0
27900;39000;36;58;2;22;0;1;0;0
56500;77500;23;34;2;11;0;1;0;0
35500;41000;51;66;2;15;0;1;0;0
56000;89000;32;55;2;23;0;1;0;0
21200;29840;37;47;2;10;0;1;0;0
18800;27000;5;37;2;32;0;1;0;0
49000;74200;6;23;2;17;0;1;0;0
113500;127000;46;55;2;9;0;1;0;0
63400;103400;53;55;2;2;0;1;0;0
97500;127000;35;46;2;11;0;1;0;0
18500;22100;35;45;2;10;0;1;0;0
25100;42500;27;47;2;20;0;1;0;0
47970;47970;52;54;2;2;0;1;0;0
40500;63000;23;58;2;35;0;1;0;0
107600;120000;37;50;2;13;0;1;0;0
76900;112000;37;65;2;28;0;1;0;0
29000;54500;38;54;2;16;0;1;0;0
36000;62900;24;44;2;20;0;1;0;0
58000;94500;22;57;2;35;0;1;0;0
26000;38500;39;59;2;20;0;1;0;0
110000;135000;44;55;2;11;0;1;0;0
30900;41500;37;55;2;18;0;1;0;0
14900;26500;2;53;2;51;0;1;0;0
48200;65900;41;64;2;23;0;1;0;0
256000;256000;60;61;2;1;0;1;0;0
37800;40900;42;59;2;17;0;1;0;0
60000;115000;8;49;2;41;0;1;0;0
51900;62000;30;38;2;8;0;1;0;0
26800;33500;14;20;2;6;0;1;0;0
57000;104000;35;60;2;25;0;1;0;0
72500;91000;39;57;2;18;0;1;0;0
76000;105250;36;48;2;12;0;1;0;0
22500;37450;17;47;2;30;0;1;0;0
41000;51550;38;42;2;4;0;1;0;0
95000;123500;41;48;2;7;0;1;0;0
35500;48350;38;58;2;20;0;1;0;0
37800;39000;52;63;2;11;0;1;0;0
62000;77550;39;62;2;23;0;1;0;0
144000;175450;56;65;2;9;0;1;0;0
76900;124000;33;59;2;26;0;1;0;0
92500;93000;56;61;2;5;0;1;0;0
48700;71500;34;63;2;29;0;1;0;0
50500;86000;31;54;2;23;0;1;0;0
20500;15900;40;62;2;22;0;1;0;0
45900;82900;56;65;2;9;0;1;0;0
31000;29000;41;48;2;7;0;1;0;0
108000;152500;36;53;2;17;0;1;0;0
57000;122000;23;54;2;31;0;1;0;0
45800;55350;44;64;2;20;0;1;0;0
63000;68000;39;43;2;4;0;1;0;0
28500;35000;51;59;2;8;0;1;0;0
43000;60500;31;50;2;19;0;1;0;0
26500;28900;37;52;2;15;0;1;0;0
26500;33000;17;28;2;11;0;1;0;0
83900;92900;46;63;2;17;0;1;0;0
59000;73000;12;23;2;11;0;1;0;0
104000;136900;47;57;2;10;0;1;0;0
64900;71900;42;53;2;11;0;1;0;0
110000;130000;37;49;2;12;0;1;0;0
61100;88000;22;55;2;33;0;1;0;0
21500;27900;8;37;2;29;0;1;0;0
74000;90000;43;64;2;21;0;1;0;0
41900;44800;38;49;2;11;0;1;0;0
51950;51620;60;62;2;2;0;1;0;0
45280;45800;42;43;2;1;0;1;0;0
74000;104750;37;53;2;16;0;1;0;0
61700;86000;39;64;2;25;0;1;0;0
45000;54500;14;23;2;9;0;1;0;0
14500;14900;34;47;2;13;0;1;0;0
68500;68900;42;43;2;1;0;1;0;0
103000;123000;55;64;2;9;0;1;0;0
312000;330000;55;60;2;5;0;1;0;0
44500;61500;48;64;2;16;0;1;0;0
49900;78900;37;66;2;29;0;1;0;0
72500;74500;56;57;2;1;0;1;0;0
31500;59500;31;58;2;27;0;1;0;0
68900;79900;57;62;2;5;0;1;0;0
30000;30000;48;61;2;13;0;1;0;0
32500;33000;22;32;2;10;0;1;0;0
210000;232200;41;49;2;8;0;1;0;0
43200;54000;14;34;2;20;0;1;0;0
62300;63200;50;51;2;1;0;1;0;0
50380;49500;42;43;2;1;0;1;0;0
82500;119000;45;61;2;16;0;1;0;0
30100;65000;4;44;2;40;0;1;0;0
11000;30000;13;38;2;25;0;1;0;0
21500;28900;6;29;2;23;0;1;0;0
50800;62230;42;52;2;10;0;1;0;0
192000;240000;54;63;2;9;0;1;0;0
15800;23200;8;39;2;31;0;1;0;0
197900;210000;57;60;2;3;0;1;0;0
2100;2300;7;29;2;22;0;1;0;0
68700;74900;40;43;2;3;0;1;0;0
88100;96500;54;62;2;8;0;1;0;0
31700;40000;40;59;2;19;0;1;0;0
76900;89000;49;59;2;10;0;1;0;0
36200;63000;27;55;2;28;0;1;0;0
92500;121800;45;62;2;17;0;1;0;0
28500;30000;38;46;2;8;0;1;0;0
167000;168120;53;54;2;1;0;1;0;0
38500;43200;14;31;2;17;0;1;0;0
29500;35500;14;35;2;21;0;1;0;0
33900;39900;4;14;2;10;0;1;0;0
69000;94000;43;64;2;21;0;1;0;0
28500;29900;37;45;2;8;0;1;0;0
64700;75000;36;41;2;5;0;1;0;0
37000;44900;46;57;2;11;0;1;0;0
18500;23700;14;35;2;21;0;1;0;0
142200;142200;56;58;2;2;0;1;0;0
77300;123200;32;55;2;23;0;1;0;0
51500;56000;12;17;2;5;0;1;0;0
88500;112900;42;62;2;20;0;1;0;0
46000;74900;28;45;2;17;0;1;0;0
56000;85000;26;57;2;31;0;1;0;0
69900;76000;44;54;2;10;0;1;0;0
37900;37900;39;44;2;5;0;1;0;0
79960;80000;45;46;2;1;0;1;0;0
45000;68000;7;17;2;10;0;1;0;0
124000;125200;41;44;2;3;0;1;0;0
53000;69400;43;58;2;15;0;1;0;0
37500;50900;43;61;2;18;0;1;0;0
87800;91500;48;56;2;8;0;1;0;0
45800;44400;43;44;2;1;0;1;0;0
46000;76000;32;59;2;27;0;1;0;0
39000;58000;34;47;2;13;0;1;0;0
26000;36700;39;65;2;26;0;1;0;0
44000;73000;19;39;2;20;0;1;0;0
25000;33000;39;62;2;23;0;1;0;0
30800;52300;20;64;2;44;0;1;0;0
122400;155000;43;55;2;12;0;1;0;0
81700;85000;40;44;2;4;0;1;0;0
33000;42500;25;38;2;13;0;1;0;0
101900;127900;51;62;2;11;0;1;0;0
275000;375000;17;50;2;33;0;1;0;0
207900;224400;57;58;2;1;0;1;0;0
60000;88920;22;52;2;30;0;1;0;0
72000;87900;53;65;2;12;0;1;0;0
56900;65500;36;53;2;17;0;1;0;0
34500;46900;10;40;2;30;0;1;0;0
119900;123500;56;61;2;5;0;1;0;0
49500;66000;39;50;2;11;0;1;0;0
71200;72000;45;53;2;8;0;1;0;0
63000;90000;23;43;2;20;0;1;0;0
59000;84000;34;57;2;23;0;1;0;0
42100;42500;40;53;2;13;0;1;0;0
31800;46500;27;39;2;12;0;1;0;0
28000;37900;42;65;2;23;0;1;0;0
81040;102500;45;53;2;8;0;1;0;0
59900;67450;51;58;2;7;0;1;0;0
53000;100000;27;63;2;36;0;1;0;0
90000;225000;25;60;2;35;0;1;0;0
103260;111000;52;57;2;5;0;1;0;0
40000;62000;36;39;2;3;0;1;0;0
24000;39000;34;45;2;11;0;1;0;0
19000;23400;8;35;2;27;0;1;0;0
49400;74750;41;61;2;20;0;1;0;0
43900;64000;36;41;2;5;0;1;0;0
47000;48400;59;61;2;2;0;1;0;0
93000;100000;44;50;2;6;0;1;0;0
77500;102290;43;64;2;21;0;1;0;0
78000;102500;40;63;2;23;0;1;0;0
61000;104000;17;57;2;40;0;1;0;0
48000;48000;53;54;2;1;0;1;0;0
92500;125000;38;59;2;21;0;1;0;0
80900;92000;46;58;2;12;0;1;0;0
113000;125000;61;66;2;5;0;1;0;0
47000;75000;27;61;2;34;0;1;0;0
14800;22000;33;52;2;19;0;1;0;0
35000;68500;35;60;2;25;0;1;0;0
119500;193000;32;55;2;23;0;1;0;0
27800;33900;13;31;2;18;0;1;0;0
27100;38000;4;35;2;31;0;1;0;0
46400;48000;40;46;2;6;0;1;0;0
30000;54500;33;57;2;24;0;1;0;0
68700;105000;32;58;2;26;0;1;0;0
57530;79500;46;61;2;15;0;1;0;0
25500;25500;46;47;2;1;0;1;0;0
52900;66500;41;56;2;15;0;1;0;0
46900;56950;41;53;2;12;0;1;0;0
19000;24600;6;32;2;26;0;1;0;0
54000;58900;49;54;2;5;0;1;0;0
15000;10650;28;30;2;2;0;1;0;0
57000;40000;58;63;2;5;0;1;0;0
25000;43000;8;27;2;19;0;1;0;0
56400;69000;38;43;2;5;0;1;0;0
114160;139900;49;62;2;13;0;1;0;0
26900;28900;44;47;2;3;0;1;0;0
23000;28500;9;30;2;21;0;1;0;0
125000;205000;23;41;2;18;0;1;0;0
20500;26000;10;35;2;25;0;1;0;0
34000;38900;39;56;2;17;0;1;0;0
18300;40150;11;62;2;51;0;1;0;0
21800;24100;11;30;2;19;0;1;0;0
94750;112500;40;55;2;15;0;1;0;0
92900;120000;33;38;2;5;0;1;0;0
82000;140500;35;62;2;27;0;1;0;0
49800;54900;41;60;2;19;0;1;0;0
72190;76470;56;57;2;1;0;1;0;0
55700;95000;32;48;2;16;0;1;0;0
27700;33000;6;28;2;22;0;1;0;0
100000;130000;46;63;2;17;0;1;0;0
42700;49500;14;22;2;8;0;1;0;0
38700;40000;39;40;2;1;0;1;0;0
92600;142500;30;61;2;31;0;1;0;0
132500;177000;32;42;2;10;0;1;0;0
40500;95000;16;63;2;47;0;1;0;0
51900;79000;38;62;2;24;0;1;0;0
38500;60000;21;56;2;35;0;1;0;0
34500;52600;36;60;2;24;0;1;0;0
36000;50900;32;44;2;12;0;1;0;0
33500;39700;12;17;2;5;0;1;0;0
23200;34500;13;37;2;24;0;1;0;0
15000;21500;6;38;2;32;0;1;0;0
23600;30500;41;53;2;12;0;1;0;0
102500;105000;45;57;2;12;0;1;0;0
71100;80000;58;64;2;6;0;1;0;0
29100;33900;42;58;2;16;0;1;0;0
92500;102000;46;59;2;13;0;1;0;0
59700;64900;51;61;2;10;0;1;0;0
72900;118500;32;66;2;34;0;1;0;0
16000;13000;39;61;2;22;0;1;0;0
65900;78200;40;56;2;16;0;1;0;0
63000;81000;34;39;2;5;0;1;0;0
46400;47800;42;43;2;1;0;1;0;0
21500;27600;12;31;2;19;0;1;0;0
62500;110000;43;58;2;15;0;1;0;0
16500;24100;6;38;2;32;0;1;0;0
63100;84000;28;40;2;12;0;1;0;0
88000;100000;38;56;2;18;0;1;0;0
35500;40500;9;14;2;5;0;1;0;0
63000;76000;50;63;2;13;0;1;0;0
37000;47500;4;14;2;10;0;1;0;0
12500;30000;36;43;2;7;0;1;0;0
53500;54300;23;31;2;8;0;1;0;0
60000;90500;27;46;2;19;0;1;0;0
46000;59900;39;62;2;23;0;1;0;0
77900;72000;49;54;2;5;0;1;0;0
45000;72000;31;54;2;23;0;1;0;0
16500;27500;23;39;2;16;0;1;0;0
23600;29000;25;36;2;11;0;1;0;0
39600;44900;46;58;2;12;0;1;0;0
49100;52200;43;44;2;1;0;1;0;0
78500;97000;22;38;2;16;0;1;0;0
38300;44500;12;16;2;4;0;1;0;0
69900;112000;31;57;2;26;0;1;0;0
125000;129500;55;58;2;3;0;1;0;0
94900;107000;48;57;2;9;0;1;0;0
30000;45500;40;62;2;22;0;1;0;0
52810;58000;56;63;2;7;0;1;0;0
59000;78000;28;39;2;11;0;1;0;0
87000;123000;41;64;2;23;0;1;0;0
25500;27900;38;51;2;13;0;1;0;0
13000;17500;5;31;2;26;0;1;0;0
123360;133000;62;63;2;1;0;1;0;0
51400;70900;43;66;2;23;0;1;0;0
22500;25000;28;31;2;3;0;1;0;0
31200;49000;12;40;2;28;0;1;0;0
16800;25000;6;33;2;27;0;1;0;0
79900;93500;42;50;2;8;0;1;0;0
79000;118000;38;64;2;26;0;1;0;0
147000;170000;38;51;2;13;0;1;0;0
33600;70000;31;55;2;24;0;1;0;0
51500;64080;48;56;2;8;0;1;0;0
149900;180000;47;63;2;16;0;1;0;0
15900;40000;11;37;2;26;0;1;0;0
17500;17800;9;26;2;17;0;1;0;0
41100;71000;33;63;2;30;0;1;0;0
24600;25600;41;51;2;10;0;1;0;0
75600;93000;32;37;2;5;0;1;0;0
32000;43500;16;39;2;23;0;1;0;0
42900;52000;41;58;2;17;0;1;0;0
57000;64370;50;57;2;7;0;1;0;0
41000;44500;22;29;2;7;0;1;0;0
58300;70900;49;54;2;5;0;1;0;0
23500;45000;9;56;2;47;0;1;0;0
3650;3650;33;34;2;1;0;1;0;0
47600;51000;42;53;2;11;0;1;0;0
119250;166200;56;61;2;5;0;1;0;0
41500;46000;18;34;2;16;0;1;0;0
26000;36500;32;36;2;4;0;1;0;0
45000;49950;48;57;2;9;0;1;0;0
56500;77500;33;43;2;10;0;1;0;0
42500;46500;31;38;2;7;0;1;0;0
58700;70500;43;57;2;14;0;1;0;0
127500;127700;49;51;2;2;0;1;0;0
126900;139000;44;55;2;11;0;1;0;0
56470;58470;48;49;2;1;0;1;0;0
57200;62000;30;35;2;5;0;1;0;0
43500;44900;61;62;2;1;0;1;0;0
28500;37000;5;27;2;22;0;1;0;0
65000;112000;37;53;2;16;0;1;0;0
39000;62000;28;43;2;15;0;1;0;0
21200;34000;9;33;2;24;0;1;0;0
73500;133000;34;62;2;28;0;1;0;0
47400;56500;23;39;2;16;0;1;0;0
37500;55100;19;47;2;28;0;1;0;0
190600;210000;44;55;2;11;0;1;0;0
66500;70500;11;14;2;3;0;1;0;0
33200;43100;12;18;2;6;0;1;0;0
92900;109000;49;63;2;14;0;1;0;0
39020;48500;44;51;2;7;0;1;0;0
60000;71100;39;48;2;9;0;1;0;0
93000;127000;39;56;2;17;0;1;0;0
30700;38700;10;32;2;22;0;1;0;0
60000;94000;43;66;2;23;0;1;0;0
24700;35000;6;29;2;23;0;1;0;0
54500;78000;38;53;2;15;0;1;0;0
40000;45000;16;34;2;18;0;1;0;0
26300;30400;18;26;2;8;0;1;0;0
45700;53000;12;31;2;19;0;1;0;0
42200;75000;36;62;2;26;0;1;0;0
15100;23100;35;47;2;12;0;1;0;0
89900;155000;27;58;2;31;0;1;0;0
30500;62000;10;62;2;52;0;1;0;0
53500;76900;38;58;2;20;0;1;0;0
15200;24500;40;54;2;14;0;1;0;0
15700;22000;4;37;2;33;0;1;0;0
62900;72500;43;65;2;22;0;1;0;0
21500;42000;12;43;2;31;0;1;0;0
49000;69900;38;63;2;25;0;1;0;0
12000;20200;24;40;2;16;0;1;0;0
60900;74000;26;39;2;13;0;1;0;0
49900;51000;31;33;2;2;0;1;0;0
36800;45500;20;33;2;13;0;1;0;0
51100;49550;49;50;2;1;0;1;0;0
38500;50000;48;61;2;13;0;1;0;0
126900;140000;43;51;2;8;0;1;0;0
67110;102500;39;63;2;24;0;1;0;0
109000;117000;38;50;2;12;0;1;0;0
73000;81900;51;58;2;7;0;1;0;0
83470;99900;45;61;2;16;0;1;0;0
12500;16900;9;40;2;31;0;1;0;0
66500;72200;57;63;2;6;0;1;0;0
106000;163000;33;57;2;24;0;1;0;0
74000;77540;38;45;2;7;0;1;0;0
88450;90650;59;60;2;1;0;1;0;0
50600;72000;38;66;2;28;0;1;0;0
45500;57500;39;59;2;20;0;1;0;0
70900;78000;48;54;2;6;0;1;0;0
107700;165000;32;43;2;11;0;1;0;0
116000;130000;45;55;2;10;0;1;0;0
43300;49500;48;57;2;9;0;1;0;0
32500;75000;8;55;2;47;0;1;0;0
18900;36300;6;39;2;33;0;1;0;0
75000;98500;55;63;2;8;0;1;0;0
61000;102000;31;56;2;25;0;1;0;0
54500;52820;54;56;2;2;0;1;0;0
149800;149500;62;63;2;1;0;1;0;0
41500;57500;7;30;2;23;0;1;0;0
28500;31000;1;11;2;10;0;1;0;0
22800;39950;14;53;2;39;0;1;0;0
17900;30000;7;41;2;34;0;1;0;0
31800;38400;14;30;2;16;0;1;0;0
54900;54500;48;51;2;3;0;1;0;0
30600;50000;39;53;2;14;0;1;0;0
43000;85000;8;57;2;49;0;1;0;0
37600;83500;13;63;2;50;0;1;0;0
137000;137000;39;40;2;1;0;1;0;0
155000;190000;56;65;2;9;0;1;0;0
69900;127000;37;62;2;25;0;1;0;0
33900;46800;14;39;2;25;0;1;0;0
59100;109000;12;41;2;29;0;1;0;0
58550;69900;53;63;2;10;0;1;0;0
51600;59400;11;17;2;6;0;1;0;0
20000;27300;12;40;2;28;0;1;0;0
35000;40000;18;27;2;9;0;1;0;0
60000;77900;30;40;2;10;0;1;0;0
85000;103000;40;55;2;15;0;1;0;0
49500;78500;37;63;2;26;0;1;0;0
28500;38000;33;44;2;11;0;1;0;0
48500;54000;14;33;2;19;0;1;0;0
52500;56500;49;50;2;1;0;1;0;0
35000;38900;45;54;2;9;0;1;0;0
44900;54500;43;59;2;16;0;1;0;0
70000;72900;29;37;2;8;0;1;0;0
65900;75000;41;55;2;14;0;1;0;0
31500;41700;34;39;2;5;0;1;0;0
95000;145000;54;65;2;11;0;1;0;0
63600;66150;59;60;2;1;0;1;0;0
19300;51000;1;55;2;54;0;1;0;0
52900;57500;38;46;2;8;0;1;0;0
38900;46000;11;18;2;7;0;1;0;0
3600;3650;17;57;2;40;0;1;0;0
43600;52500;36;41;2;5;0;1;0;0
28800;40800;6;28;2;22;0;1;0;0
27500;35000;38;62;2;24;0;1;0;0
43900;47000;22;38;2;16;0;1;0;0
19000;58900;7;49;2;42;0;1;0;0
32000;40000;44;58;2;14;0;1;0;0
58000;67500;38;43;2;5;0;1;0;0
23000;30500;13;34;2;21;0;1;0;0
37500;51500;11;22;2;11;0;1;0;0
89900;106000;43;63;2;20;0;1;0;0
18400;23600;6;35;2;29;0;1;0;0
90000;119500;46;63;2;17;0;1;0;0
75500;104900;38;56;2;18;0;1;0;0
41700;57500;31;43;2;12;0;1;0;0
37300;41900;14;31;2;17;0;1;0;0
27500;29000;26;33;2;7;0;1;0;0
64500;89900;39;52;2;13;0;1;0;0
35000;79900;16;63;2;47;0;1;0;0
90100;99000;58;65;2;7;0;1;0;0
21400;35900;41;64;2;23;0;1;0;0
49500;69900;22;56;2;34;0;1;0;0
77900;87400;48;66;2;18;0;1;0;0
66900;98000;38;61;2;23;0;1;0;0
61700;78000;53;62;2;9;0;1;0;0
74900;85000;57;62;2;5;0;1;0;0
85000;100000;45;57;2;12;0;1;0;0
75900;82000;52;58;2;6;0;1;0;0
35900;45000;46;60;2;14;0;1;0;0
86200;103500;50;59;2;9;0;1;0;0
135000;176000;41;60;2;19;0;1;0;0
25500;27500;42;52;2;10;0;1;0;0
52200;65700;39;57;2;18;0;1;0;0
133000;143500;55;60;2;5;0;1;0;0
85900;105000;55;65;2;10;0;1;0;0
40900;48050;43;55;2;12;0;1;0;0
58000;71000;31;42;2;11;0;1;0;0
88000;110000;56;65;2;9;0;1;0;0
41500;56000;11;30;2;19;0;1;0;0
42100;48000;36;38;2;2;0;1;0;0
58300;59180;46;47;2;1;0;1;0;0
28500;32900;46;59;2;13;0;1;0;0
49400;57400;36;38;2;2;0;1;0;0
35600;49000;38;58;2;20;0;1;0;0
37450;44500;52;54;2;2;0;1;0;0
31500;38700;10;34;2;24;0;1;0;0
83500;88000;47;53;2;6;0;1;0;0
31000;38200;18;34;2;16;0;1;0;0
18500;30000;27;41;2;14;0;1;0;0
50680;50700;60;61;2;1;0;1;0;0
148000;223500;40;50;2;10;0;1;0;0
28500;35800;51;59;2;8;0;1;0;0
22700;33000;12;33;2;21;0;1;0;0
21500;24600;58;63;2;5;0;1;0;0
62000;73300;43;57;2;14;0;1;0;0
56000;79500;29;46;2;17;0;1;0;0
123480;123480;62;64;2;2;0;1;0;0
23100;25600;22;36;2;14;0;1;0;0
35500;47500;39;65;2;26;0;1;0;0
73900;75100;54;55;2;1;0;1;0;0
15000;21900;34;48;2;14;0;1;0;0
100000;137500;38;49;2;11;0;1;0;0
41900;64000;39;62;2;23;0;1;0;0
4650;4650;30;31;2;1;0;1;0;0
36000;43500;12;28;2;16;0;1;0;0
21000;27500;16;34;2;18;0;1;0;0
19800;28000;6;38;2;32;0;1;0;0
77250;82900;58;60;2;2;0;1;0;0
26000;38920;16;42;2;26;0;1;0;0
58000;75900;38;63;2;25;0;1;0;0
21000;57500;8;59;2;51;0;1;0;0
46000;84500;32;51;3;19;0;0;1;0
61500;71500;42;59;3;17;0;0;1;0
33500;68500;32;54;3;22;0;0;1;0
44500;58000;29;36;3;7;0;0;1;0
14800;47950;14;49;3;35;0;0;1;0
25100;65000;32;59;3;27;0;0;1;0
11500;33500;15;60;3;45;0;0;1;0
157000;174000;47;63;3;16;0;0;1;0
17500;19400;8;19;3;11;0;0;1;0
170000;184000;60;64;3;4;0;0;1;0
16800;31800;14;39;3;25;0;0;1;0
14900;39000;34;57;3;23;0;0;1;0
18300;15500;37;38;3;1;0;0;1;0
37500;41500;19;28;3;9;0;0;1;0
78000;83000;61;62;3;1;0;0;1;0
38800;50800;33;39;3;6;0;0;1;0
165000;287000;54;64;3;10;0;0;1;0
66000;155000;43;65;3;22;0;0;1;0
28500;36550;42;54;3;12;0;0;1;0
61900;62000;45;57;3;12;0;0;1;0
27200;28900;28;30;3;2;0;0;1;0
56700;127500;30;49;3;19;0;0;1;0
48900;67900;41;62;3;21;0;0;1;0
82500;155000;10;28;3;18;0;0;1;0
15700;21200;7;31;3;24;0;0;1;0
35000;78500;14;38;3;24;0;0;1;0
21800;46900;17;44;3;27;0;0;1;0
185000;187000;63;64;3;1;0;0;1;0
84050;90500;47;64;3;17;0;0;1;0
63250;109950;54;61;3;7;0;0;1;0
40000;94000;38;65;3;27;0;0;1;0
13800;19000;8;38;3;30;0;0;1;0
39850;45600;54;57;3;3;0;0;1;0
32500;53000;49;60;3;11;0;0;1;0
19500;25300;11;28;3;17;0;0;1;0
47000;31900;56;57;3;1;0;0;1;0
23600;51800;7;40;3;33;0;0;1;0
72200;99500;38;53;3;15;0;0;1;0
82950;83500;43;45;3;2;0;0;1;0
55950;58700;53;54;3;1;0;0;1;0
65500;66210;41;43;3;2;0;0;1;0
10600;13300;9;32;3;23;0;0;1;0
23000;58000;18;60;3;42;0;0;1;0
20500;20900;12;19;3;7;0;0;1;0
61800;68290;37;43;3;6;0;0;1;0
23000;33500;30;36;3;6;0;0;1;0
107200;120000;47;60;3;13;0;0;1;0
25000;71500;26;58;3;32;0;0;1;0
59750;69500;52;54;3;2;0;0;1;0
37500;78000;31;54;3;23;0;0;1;0
16000;34830;15;43;3;28;0;0;1;0
24900;28200;6;15;3;9;0;0;1;0
33600;49900;33;39;3;6;0;0;1;0
35000;59900;26;40;3;14;0;0;1;0
46500;47600;33;34;3;1;0;0;1;0
70000;73500;58;59;3;1;0;0;1;0
21000;35350;22;55;3;33;0;0;1;0
20100;34500;33;46;3;13;0;0;1;0
36500;48810;36;44;3;8;0;0;1;0
43500;55000;14;18;3;4;0;0;1;0
31560;48000;41;55;3;14;0;0;1;0
24900;38440;36;60;3;24;0;0;1;0
184500;148500;60;61;3;1;0;0;1;0
43300;80000;29;51;3;22;0;0;1;0
61950;71950;44;50;3;6;0;0;1;0
43000;89500;23;39;3;16;0;0;1;0
83000;98160;54;61;3;7;0;0;1;0
48500;116000;18;38;3;20;0;0;1;0
58500;72500;42;58;3;16;0;0;1;0
27500;67300;23;41;3;18;0;0;1;0
42800;68000;37;60;3;23;0;0;1;0
29000;47500;36;58;3;22;0;0;1;0
14300;18700;17;31;3;14;0;0;1;0
40700;40900;19;21;3;2;0;0;1;0
29500;57500;37;60;3;23;0;0;1;0
33600;57600;33;47;3;14;0;0;1;0
37000;47000;58;63;3;5;0;0;1;0
27000;69500;29;58;3;29;0;0;1;0
64500;89000;38;49;3;11;0;0;1;0
20000;26300;1;27;3;26;0;0;1;0
89950;89950;59;60;3;1;0;0;1;0
18500;40000;36;58;3;22;0;0;1;0
16100;26500;39;55;3;16;0;0;1;0
130950;134500;50;53;3;3;0;0;1;0
111000;141000;43;54;3;11;0;0;1;0
54900;108000;29;63;3;34;0;0;1;0
28000;54000;30;34;3;4;0;0;1;0
35300;45000;1;11;3;10;0;0;1;0
70500;129500;31;61;3;30;0;0;1;0
118000;120000;54;62;3;8;0;0;1;0
84950;86950;45;47;3;2;0;0;1;0
28200;40700;31;38;3;7;0;0;1;0
11900;21500;18;40;3;22;0;0;1;0
46500;116500;23;58;3;35;0;0;1;0
48000;68000;10;18;3;8;0;0;1;0
65100;82950;38;55;3;17;0;0;1;0
68500;80000;39;53;3;14;0;0;1;0
16200;35200;34;52;3;18;0;0;1;0
13200;14700;2;9;3;7;0;0;1;0
64900;75500;48;55;3;7;0;0;1;0
24900;54450;26;44;3;18;0;0;1;0
72450;89950;46;63;3;17;0;0;1;0
500000;525000;56;57;3;1;0;0;1;0
70950;104900;41;59;3;18;0;0;1;0
69000;81900;46;54;3;8;0;0;1;0
75900;133000;34;57;3;23;0;0;1;0
17000;45000;12;56;3;44;0;0;1;0
156900;173000;55;64;3;9;0;0;1;0
32500;36500;13;29;3;16;0;0;1;0
122950;123900;47;53;3;6;0;0;1;0
18500;42000;14;49;3;35;0;0;1;0
32800;50000;34;44;3;10;0;0;1;0
70700;74100;47;57;3;10;0;0;1;0
62000;103000;38;64;3;26;0;0;1;0
61000;65200;10;13;3;3;0;0;1;0
12500;12100;8;25;3;17;0;0;1;0
14900;30500;29;43;3;14;0;0;1;0
56100;118500;34;59;3;25;0;0;1;0
28500;45970;35;54;3;19;0;0;1;0
37100;57320;34;47;3;13;0;0;1;0
51200;87000;33;59;3;26;0;0;1;0
21000;44000;9;45;3;36;0;0;1;0
33900;72000;33;62;3;29;0;0;1;0
21400;26500;18;28;3;10;0;0;1;0
55000;55000;61;62;3;1;0;0;1;0
33400;58850;26;45;3;19;0;0;1;0
27000;42000;28;38;3;10;0;0;1;0
62300;95000;40;63;3;23;0;0;1;0
81850;87500;45;56;3;11;0;0;1;0
77300;85000;41;64;3;23;0;0;1;0
115000;118000;55;61;3;6;0;0;1;0
104200;104250;47;49;3;2;0;0;1;0
62000;92000;38;60;3;22;0;0;1;0
55000;53200;4;21;3;17;0;0;1;0
83750;87910;51;53;3;2;0;0;1;0
31500;58000;27;39;3;12;0;0;1;0
56000;61500;26;31;3;5;0;0;1;0
165000;200000;41;55;3;14;0;0;1;0
41000;66000;39;61;3;22;0;0;1;0
134900;185000;38;66;3;28;0;0;1;0
46900;79900;26;45;3;19;0;0;1;0
91300;103500;53;57;3;4;0;0;1;0
46870;47000;65;66;3;1;0;0;1;0
20200;23600;32;36;3;4;0;0;1;0
66000;86000;46;61;3;15;0;0;1;0
14300;20100;9;35;3;26;0;0;1;0
52720;53000;58;59;3;1;0;0;1;0
78000;79350;61;62;3;1;0;0;1;0
32900;65000;33;61;3;28;0;0;1;0
20200;68750;10;53;3;43;0;0;1;0
62440;75000;42;49;3;7;0;0;1;0
72350;87000;46;58;3;12;0;0;1;0
81500;116000;49;61;3;12;0;0;1;0
69900;79900;52;60;3;8;0;0;1;0
129850;132500;59;62;3;3;0;0;1;0
42500;48000;37;43;3;6;0;0;1;0
23300;41000;22;39;3;17;0;0;1;0
18500;31500;34;47;3;13;0;0;1;0
22300;28850;37;42;3;5;0;0;1;0
73240;79290;52;53;3;1;0;0;1;0
18000;26700;12;30;3;18;0;0;1;0
60000;83750;56;63;3;7;0;0;1;0
24500;54400;22;46;3;24;0;0;1;0
34800;61500;36;47;3;11;0;0;1;0
252000;257000;63;64;3;1;0;0;1;0
47800;50900;33;34;3;1;0;0;1;0
39500;47880;46;59;3;13;0;0;1;0
25100;33400;12;31;3;19;0;0;1;0
155000;180000;43;46;3;3;0;0;1;0
67450;79950;46;55;3;9;0;0;1;0
19500;32500;29;39;3;10;0;0;1;0
22600;30700;15;30;3;15;0;0;1;0
82000;87500;49;65;3;16;0;0;1;0
20300;58000;7;50;3;43;0;0;1;0
34000;34500;57;58;3;1;0;0;1;0
65000;76900;31;34;3;3;0;0;1;0
28500;71420;18;52;3;34;0;0;1;0
27200;63000;30;59;3;29;0;0;1;0
36000;45000;10;22;3;12;0;0;1;0
24500;35000;8;22;3;14;0;0;1;0
93500;110000;41;54;3;13;0;0;1;0
56000;72500;37;38;3;1;0;0;1;0
129900;139000;46;55;3;9;0;0;1;0
94900;94900;53;54;3;1;0;0;1;0
69500;128900;30;43;3;13;0;0;1;0
45400;67900;38;57;3;19;0;0;1;0
249000;325000;56;65;3;9;0;0;1;0
25400;38000;29;36;3;7;0;0;1;0
62700;71930;41;46;3;5;0;0;1;0
112000;132000;52;60;3;8;0;0;1;0
91500;100500;46;60;3;14;0;0;1;0
32500;43000;17;24;3;7;0;0;1;0
66950;67000;61;62;3;1;0;0;1;0
137500;175000;40;41;3;1;0;0;1;0
23500;28500;27;29;3;2;0;0;1;0
115000;129000;54;62;3;8;0;0;1;0
33000;45500;35;39;3;4;0;0;1;0
21000;49350;20;60;3;40;0;0;1;0
29500;46900;35;38;3;3;0;0;1;0
59900;69300;55;59;3;4;0;0;1;0
35900;59500;32;44;3;12;0;0;1;0
91000;107500;50;65;3;15;0;0;1;0
33600;56500;39;58;3;19;0;0;1;0
50400;124000;27;62;3;35;0;0;1;0
25500;41900;33;41;3;8;0;0;1;0
71930;88500;47;62;3;15;0;0;1;0
68500;71900;51;62;3;11;0;0;1;0
15000;28000;29;39;3;10;0;0;1;0
28000;33300;31;33;3;2;0;0;1;0
58000;69600;43;53;3;10;0;0;1;0
155000;169900;47;64;3;17;0;0;1;0
146350;175000;55;58;3;3;0;0;1;0
27600;59850;13;45;3;32;0;0;1;0
38200;85000;29;65;3;36;0;0;1;0
34000;79500;24;58;3;34;0;0;1;0
60500;62000;58;65;3;7;0;0;1;0
73000;117000;37;52;3;15;0;0;1;0
67000;115000;26;43;3;17;0;0;1;0
89000;117000;46;54;3;8;0;0;1;0
34500;38300;38;39;3;1;0;0;1;0
43500;65000;38;64;3;26;0;0;1;0
38000;85500;26;63;3;37;0;0;1;0
63300;159900;25;54;3;29;0;0;1;0
56900;67000;46;52;3;6;0;0;1;0
56500;112000;31;64;3;33;0;0;1;0
18300;27500;31;39;3;8;0;0;1;0
80000;96500;49;60;3;11;0;0;1;0
61800;117000;24;50;3;26;0;0;1;0
97500;140000;53;57;3;4;0;0;1;0
45370;56000;52;63;3;11;0;0;1;0
51300;66000;41;58;3;17;0;0;1;0
23200;42000;32;44;3;12;0;0;1;0
32100;56000;35;57;3;22;0;0;1;0
15900;22500;13;34;3;21;0;0;1;0
17900;32800;22;38;3;16;0;0;1;0
16360;33000;43;61;3;18;0;0;1;0
155000;235000;45;64;3;19;0;0;1;0
87500;108300;58;65;3;7;0;0;1;0
16500;21000;15;32;3;17;0;0;1;0
13700;36000;14;49;3;35;0;0;1;0
105000;112500;52;64;3;12;0;0;1;0
105500;177000;38;59;3;21;0;0;1;0
33500;83250;31;66;3;35;0;0;1;0
13500;26980;30;44;3;14;0;0;1;0
68000;86900;39;66;3;27;0;0;1;0
18100;25500;18;35;3;17;0;0;1;0
60800;71500;54;65;3;11;0;0;1;0
63700;74500;25;32;3;7;0;0;1;0
224620;240000;53;60;3;7;0;0;1;0
20900;53790;14;45;3;31;0;0;1;0
51000;104000;29;55;3;26;0;0;1;0
23700;55600;33;54;3;21;0;0;1;0
34500;38200;52;56;3;4;0;0;1;0
123000;122000;60;65;3;5;0;0;1;0
55000;91800;23;38;3;15;0;0;1;0
24600;36000;37;43;3;6;0;0;1;0
24400;80600;9;61;3;52;0;0;1;0
21400;39300;13;34;3;21;0;0;1;0
56800;61950;39;42;3;3;0;0;1;0
35000;72900;35;61;3;26;0;0;1;0
23500;58000;26;58;3;32;0;0;1;0
20800;44900;37;60;3;23;0;0;1;0
47900;103750;18;46;3;28;0;0;1;0
52500;72500;18;30;3;12;0;0;1;0
100800;234500;29;54;3;25;0;0;1;0
32000;56500;41;60;3;19;0;0;1;0
11000;36000;9;64;3;55;0;0;1;0
22900;38300;30;41;3;11;0;0;1;0
26000;34900;26;27;3;1;0;0;1;0
65000;83500;46;59;3;13;0;0;1;0
41450;49550;49;54;3;5;0;0;1;0
16300;24700;28;38;3;10;0;0;1;0
92500;106000;42;56;3;14;0;0;1;0
20000;56500;26;62;3;36;0;0;1;0
21000;40000;26;43;3;17;0;0;1;0
17500;19900;15;33;3;18;0;0;1;0
23200;31300;16;29;3;13;0;0;1;0
26050;26250;53;54;3;1;0;0;1;0
59500;185000;15;63;3;48;0;0;1;0
40000;58000;32;38;3;6;0;0;1;0
18300;30300;23;38;3;15;0;0;1;0
31610;140000;41;63;3;22;0;0;1;0
47500;99950;32;65;3;33;0;0;1;0
14000;31900;14;38;3;24;0;0;1;0
34900;63900;36;61;3;25;0;0;1;0
30500;77000;16;64;3;48;0;0;1;0
33500;72500;23;54;3;31;0;0;1;0
9700;11550;39;42;3;3;0;0;1;0
32400;56000;26;40;3;14;0;0;1;0
39100;56950;38;58;3;20;0;0;1;0
21000;21300;32;33;3;1;0;0;1;0
97500;98000;59;60;3;1;0;0;1;0
125500;125500;57;59;3;2;0;0;1;0
31900;71500;26;58;3;32;0;0;1;0
35800;58000;39;65;3;26;0;0;1;0
98000;110000;52;65;3;13;0;0;1;0
31000;36660;41;52;3;11;0;0;1;0
61100;63350;52;53;3;1;0;0;1;0
43500;135500;29;58;3;29;0;0;1;0
54100;58000;41;43;3;2;0;0;1;0
44000;61000;12;22;3;10;0;0;1;0
46600;94000;24;59;3;35;0;0;1;0
57800;85500;31;39;3;8;0;0;1;0
32700;49000;37;61;3;24;0;0;1;0
16800;28900;20;37;3;17;0;0;1;0
51950;69900;44;56;3;12;0;0;1;0
60200;95000;35;66;3;31;0;0;1;0
18600;32500;27;42;3;15;0;0;1;0
73000;103500;36;56;3;20;0;0;1;0
12700;20100;7;30;3;23;0;0;1;0
33200;37500;5;9;3;4;0;0;1;0
20700;24700;13;28;3;15;0;0;1;0
58000;73000;30;38;3;8;0;0;1;0
11700;19000;9;40;3;31;0;0;1;0
123000;130000;39;45;3;6;0;0;1;0
35000;49000;50;63;3;13;0;0;1;0
140500;144500;52;63;3;11;0;0;1;0
22900;43000;22;39;3;17;0;0;1;0
62500;122000;28;39;3;11;0;0;1;0
80000;84500;44;47;3;3;0;0;1;0
74400;87500;42;63;3;21;0;0;1;0
100000;172900;30;42;3;12;0;0;1;0
30500;42800;33;37;3;4;0;0;1;0
55000;56150;61;62;3;1;0;0;1;0
62500;65900;31;34;3;3;0;0;1;0
17100;34950;7;43;3;36;0;0;1;0
82500;149000;35;58;3;23;0;0;1;0
39000;92500;30;61;3;31;0;0;1;0
31900;44000;63;64;3;1;0;0;1;0
64000;135000;28;63;3;35;0;0;1;0
100000;287000;33;59;3;26;0;0;1;0
24100;39500;35;46;3;11;0;0;1;0
64900;134000;27;37;3;10;0;0;1;0
138500;171000;42;64;3;22;0;0;1;0
74500;95000;32;36;3;4;0;0;1;0
43000;68000;47;57;3;10;0;0;1;0
24000;45870;31;42;3;11;0;0;1;0
52000;75000;29;30;3;1;0;0;1;0
17900;32500;19;38;3;19;0;0;1;0
30500;60500;31;57;3;26;0;0;1;0
21200;55000;34;63;3;29;0;0;1;0
57900;74900;47;56;3;9;0;0;1;0
37000;105900;29;62;3;33;0;0;1;0
220000;500000;43;63;3;20;0;0;1;0
85300;110000;39;57;3;18;0;0;1;0
18200;37900;7;37;3;30;0;0;1;0
80000;89500;53;58;3;5;0;0;1;0
32000;105000;10;38;3;28;0;0;1;0
47000;75000;30;41;3;11;0;0;1;0
34000;48500;31;37;3;6;0;0;1;0
51800;60000;31;36;3;5;0;0;1;0
69000;83500;26;35;3;9;0;0;1;0
123000;137500;56;65;3;9;0;0;1;0
29200;45700;22;36;3;14;0;0;1;0
75000;120700;30;39;3;9;0;0;1;0
15500;58250;16;54;3;38;0;0;1;0
27400;45410;34;46;3;12;0;0;1;0
212500;270000;39;59;3;20;0;0;1;0
37000;40500;31;32;3;1;0;0;1;0
22450;27480;42;51;3;9;0;0;1;0
22500;62000;30;66;3;36;0;0;1;0
43900;67950;32;46;3;14;0;0;1;0
36200;104000;20;56;3;36;0;0;1;0
34000;43500;19;30;3;11;0;0;1;0
23600;58000;9;43;3;34;0;0;1;0
21900;56500;34;62;3;28;0;0;1;0
58000;82000;38;62;3;24;0;0;1;0
116000;173000;46;63;3;17;0;0;1;0
60500;68000;25;31;3;6;0;0;1;0
55000;81890;43;60;3;17;0;0;1;0
39500;45000;32;35;3;3;0;0;1;0
27500;32900;25;29;3;4;0;0;1;0
17100;35600;9;56;3;47;0;0;1;0
43300;91500;28;54;3;26;0;0;1;0
37900;75000;11;38;3;27;0;0;1;0
33600;61940;33;57;3;24;0;0;1;0
32400;58000;15;38;3;23;0;0;1;0
64500;73000;26;32;3;6;0;0;1;0
13400;19000;32;37;3;5;0;0;1;0
64700;71600;13;17;3;4;0;0;1;0
47500;177000;14;58;3;44;0;0;1;0
31900;105000;10;63;3;53;0;0;1;0
90500;90750;52;53;3;1;0;0;1;0
43300;44800;37;38;3;1;0;0;1;0
43800;67500;18;34;3;16;0;0;1;0
46000;47500;32;33;3;1;0;0;1;0
90000;114000;50;54;3;4;0;0;1;0
56500;104500;23;38;3;15;0;0;1;0
28000;33400;26;27;3;1;0;0;1;0
25900;31100;26;31;3;5;0;0;1;0
23000;49500;6;40;3;34;0;0;1;0
98950;102050;58;59;3;1;0;0;1;0
51700;97750;33;61;3;28;0;0;1;0
30900;38000;27;33;3;6;0;0;1;0
17500;24900;9;29;3;20;0;0;1;0
53500;97500;28;41;3;13;0;0;1;0
26400;91930;28;62;3;34;0;0;1;0
45650;64600;43;49;3;6;0;0;1;0
34500;61900;15;45;3;30;0;0;1;0
135000;165000;47;65;3;18;0;0;1;0
25500;37000;40;52;3;12;0;0;1;0
19500;31000;30;34;3;4;0;0;1;0
12900;26500;9;38;3;29;0;0;1;0
11100;15700;9;33;3;24;0;0;1;0
26300;38300;29;38;3;9;0;0;1;0
21000;77000;25;56;3;31;0;0;1;0
56950;69950;44;54;3;10;0;0;1;0
13900;20000;33;38;3;5;0;0;1;0
58500;65500;20;24;3;4;0;0;1;0
64200;98500;36;53;3;17;0;0;1;0
99000;106000;50;60;3;10;0;0;1;0
43000;92000;10;37;3;27;0;0;1;0
22000;52710;24;54;3;30;0;0;1;0
23500;66000;18;58;3;40;0;0;1;0
36000;60000;36;47;3;11;0;0;1;0
45500;66500;28;35;3;7;0;0;1;0
15800;28500;29;44;3;15;0;0;1;0
39500;52900;38;57;3;19;0;0;1;0
35500;36200;25;29;3;4;0;0;1;0
65000;95500;30;39;3;9;0;0;1;0
124000;182000;32;39;3;7;0;0;1;0
132000;143890;54;59;3;5;0;0;1;0
21400;34200;15;31;3;16;0;0;1;0
17500;23700;27;35;3;8;0;0;1;0
64950;66000;46;64;3;18;0;0;1;0
37500;66760;31;56;3;25;0;0;1;0
55000;58000;28;32;3;4;0;0;1;0
64750;80900;42;61;3;19;0;0;1;0
108500;157250;38;57;3;19;0;0;1;0
115000;154500;43;49;3;6;0;0;1;0
17500;36500;33;39;3;6;0;0;1;0
31900;41700;33;38;3;5;0;0;1;0
126500;235000;39;61;3;22;0;0;1;0
41000;91500;25;38;3;13;0;0;1;0
65000;80000;53;57;3;4;0;0;1;0
66000;95000;32;43;3;11;0;0;1;0
19300;22800;32;40;3;8;0;0;1;0
50000;112000;16;51;3;35;0;0;1;0
20300;27000;9;25;3;16;0;0;1;0
57500;80000;28;34;3;6;0;0;1;0
66500;68000;46;51;3;5;0;0;1;0
64500;81700;43;49;3;6;0;0;1;0
25700;36300;26;35;3;9;0;0;1;0
59070;85000;44;57;3;13;0;0;1;0
40000;61900;42;55;3;13;0;0;1;0
61000;140000;27;51;3;24;0;0;1;0
18700;27800;17;37;3;20;0;0;1;0
18000;30000;30;34;3;4;0;0;1;0
46800;83900;32;46;3;14;0;0;1;0
22700;44500;14;32;3;18;0;0;1;0
37500;60000;45;64;3;19;0;0;1;0
19000;55500;30;49;3;19;0;0;1;0
69000;82000;36;49;3;13;0;0;1;0
79500;91000;50;63;3;13;0;0;1;0
68900;102500;38;49;3;11;0;0;1;0
27900;64500;12;39;3;27;0;0;1;0
138000;154000;47;56;3;9;0;0;1;0
60150;70000;42;54;3;12;0;0;1;0
33900;63950;30;46;3;16;0;0;1;0
55900;63000;49;58;3;9;0;0;1;0
55280;63050;46;52;3;6;0;0;1;0
49800;71410;38;58;3;20;0;0;1;0
34000;53090;37;54;3;17;0;0;1;0
25500;36100;24;35;3;11;0;0;1;0
20400;31600;16;23;3;7;0;0;1;0
53000;127500;24;63;3;39;0;0;1;0
65900;70000;44;61;3;17;0;0;1;0
71850;75000;43;45;3;2;0;0;1;0
53900;107200;26;47;3;21;0;0;1;0
22500;42000;36;60;3;24;0;0;1;0
61000;89500;33;41;3;8;0;0;1;0
12600;48700;19;63;3;44;0;0;1;0
57000;70700;26;32;3;6;0;0;1;0
17000;23500;25;35;3;10;0;0;1;0
13500;39500;9;64;3;55;0;0;1;0
15900;25900;15;35;3;20;0;0;1;0
77500;78000;62;63;3;1;0;0;1;0
24570;39500;43;62;3;19;0;0;1;0
17500;46000;24;31;3;7;0;0;1;0
23500;61000;25;62;3;37;0;0;1;0
52100;64070;40;47;3;7;0;0;1;0
86450;85950;45;47;3;2;0;0;1;0
23700;48500;35;63;3;28;0;0;1;0
50900;80900;37;62;3;25;0;0;1;0
49400;110050;14;50;3;36;0;0;1;0
38900;65090;40;49;3;9;0;0;1;0
60200;90000;30;38;3;8;0;0;1;0
68000;132500;42;65;3;23;0;0;1;0
17250;30550;44;54;3;10;0;0;1;0
17600;40500;33;53;3;20;0;0;1;0
46900;54500;18;21;3;3;0;0;1;0
35400;82900;13;50;3;37;0;0;1;0
62300;83000;39;47;3;8;0;0;1;0
81900;84000;45;48;3;3;0;0;1;0
193500;193500;60;62;3;2;0;0;1;0
49500;55900;29;33;3;4;0;0;1;0
41500;49500;6;14;3;8;0;0;1;0
37900;39500;18;20;3;2;0;0;1;0
82500;94090;54;57;3;3;0;0;1;0
28500;57500;8;39;3;31;0;0;1;0
32400;52000;38;55;3;17;0;0;1;0
109400;159900;30;35;3;5;0;0;1;0
32900;55000;31;36;3;5;0;0;1;0
17000;42040;24;45;3;21;0;0;1;0
33500;110000;7;52;3;45;0;0;1;0
40000;63000;34;48;3;14;0;0;1;0
42200;71000;39;62;3;23;0;0;1;0
67500;185000;18;60;3;42;0;0;1;0
59500;59500;54;56;3;2;0;0;1;0
18200;21500;29;35;3;6;0;0;1;0
24000;54900;32;62;3;30;0;0;1;0
63000;63500;60;61;3;1;0;0;1;0
61000;62000;24;31;3;7;0;0;1;0
89700;125790;38;63;3;25;0;0;1;0
24500;31000;32;35;3;3;0;0;1;0
138500;138500;64;65;3;1;0;0;1;0
71900;105000;39;65;3;26;0;0;1;0
36000;159000;9;62;3;53;0;0;1;0
160000;160100;61;62;3;1;0;0;1;0
49900;68500;38;50;3;12;0;0;1;0
34500;51000;11;31;3;20;0;0;1;0
37500;45500;14;22;3;8;0;0;1;0
51500;78000;40;64;3;24;0;0;1;0
15000;24300;7;36;3;29;0;0;1;0
310000;440000;48;59;3;11;0;0;1;0
15500;25400;26;37;3;11;0;0;1;0
46500;86000;34;55;3;21;0;0;1;0
21400;27600;19;34;3;15;0;0;1;0
16700;23100;17;31;3;14;0;0;1;0
30900;56000;10;39;3;29;0;0;1;0
29400;70000;26;47;3;21;0;0;1;0
53700;72200;31;39;3;8;0;0;1;0
72500;111000;27;36;3;9;0;0;1;0
57000;51000;27;30;3;3;0;0;1;0
40800;62000;37;60;3;23;0;0;1;0
80900;82400;42;47;3;5;0;0;1;0
29900;62500;11;38;3;27;0;0;1;0
18500;30250;36;63;3;27;0;0;1;0
39000;80000;34;59;3;25;0;0;1;0
12500;12000;26;27;3;1;0;0;1;0
70700;79000;32;34;3;2;0;0;1;0
83700;91500;42;53;3;11;0;0;1;0
18100;79900;27;59;3;32;0;0;1;0
44000;47000;49;54;3;5;0;0;1;0
47500;106000;33;65;3;32;0;0;1;0
20700;38000;7;35;3;28;0;0;1;0
36700;66750;29;63;3;34;0;0;1;0
31800;46030;40;47;3;7;0;0;1;0
12000;14600;15;27;3;12;0;0;1;0
28200;72000;11;58;3;47;0;0;1;0
21500;27900;16;32;3;16;0;0;1;0
70000;86900;46;57;3;11;0;0;1;0
52000;70000;17;21;3;4;0;0;1;0
25200;48190;27;43;3;16;0;0;1;0
50000;87500;32;47;3;15;0;0;1;0
28000;61000;30;65;3;35;0;0;1;0
79900;88500;57;64;3;7;0;0;1;0
26800;34500;32;35;3;3;0;0;1;0
43500;85000;23;47;3;24;0;0;1;0
230000;285000;57;61;3;4;0;0;1;0
75500;165000;28;65;3;37;0;0;1;0
21700;50000;31;54;3;23;0;0;1;0
18100;23500;20;31;3;11;0;0;1;0
25500;56000;33;58;3;25;0;0;1;0
97500;98500;54;55;3;1;0;0;1;0
19900;34000;20;37;3;17;0;0;1;0
19700;65000;16;62;3;46;0;0;1;0
58330;58500;50;51;3;1;0;0;1;0
53900;53900;62;63;3;1;0;0;1;0
113500;129900;54;62;3;8;0;0;1;0
61900;86500;39;65;3;26;0;0;1;0
63000;107500;30;44;3;14;0;0;1;0
11900;21900;28;39;3;11;0;0;1;0
52500;100000;30;47;3;17;0;0;1;0
46800;80000;33;65;3;32;0;0;1;0
70000;220000;14;43;3;29;0;0;1;0
13000;45000;23;56;3;33;0;0;1;0
57300;61900;42;48;3;6;0;0;1;0
49500;177000;26;59;3;33;0;0;1;0
83000;88500;57;58;3;1;0;0;1;0
29400;59000;31;49;3;18;0;0;1;0
35000;93500;17;42;3;25;0;0;1;0
36000;42500;9;22;3;13;0;0;1;0
69900;82540;43;50;3;7;0;0;1;0
20200;46500;32;57;3;25;0;0;1;0
91950;100000;46;51;3;5;0;0;1;0
16500;28000;39;55;3;16;0;0;1;0
20200;35000;16;45;3;29;0;0;1;0
49400;118500;19;43;3;24;0;0;1;0
32000;52470;30;44;3;14;0;0;1;0
68700;68300;37;38;3;1;0;0;1;0
59450;64980;49;58;3;9;0;0;1;0
39000;60310;32;44;3;12;0;0;1;0
29400;56000;39;62;3;23;0;0;1;0
48000;90000;36;57;3;21;0;0;1;0
52900;63500;32;36;3;4;0;0;1;0
61900;65000;56;65;3;9;0;0;1;0
25500;45000;9;26;3;17;0;0;1;0
19900;22900;11;20;3;9;0;0;1;0
87900;88150;51;53;3;2;0;0;1;0
40500;125000;7;62;3;55;0;0;1;0
60900;112000;43;65;3;22;0;0;1;0
185000;199000;56;65;3;9;0;0;1;0
162500;172000;43;46;3;3;0;0;1;0
60050;76000;42;63;3;21;0;0;1;0
50400;75000;39;58;3;19;0;0;1;0
17700;33350;35;43;3;8;0;0;1;0
73500;73500;55;56;3;1;0;0;1;0
21500;44500;33;64;3;31;0;0;1;0
44000;83500;36;59;3;23;0;0;1;0
50900;130000;17;58;3;41;0;0;1;0
13400;40000;15;57;3;42;0;0;1;0
26000;59500;51;60;3;9;0;0;1;0
65900;92500;39;64;3;25;0;0;1;0
49500;66000;34;50;3;16;0;0;1;0
19700;29000;24;36;3;12;0;0;1;0
26500;55000;34;57;3;23;0;0;1;0
11500;18200;8;34;3;26;0;0;1;0
16100;20100;16;28;3;12;0;0;1;0
32350;36700;42;54;3;12;0;0;1;0
32900;49900;35;50;3;15;0;0;1;0
81000;122000;36;53;3;17;0;0;1;0
36800;110500;13;62;3;49;0;0;1;0
12000;29000;7;52;3;45;0;0;1;0
34900;101000;14;52;3;38;0;0;1;0
28100;85500;9;59;3;50;0;0;1;0
35400;35420;39;41;3;2;0;0;1;0
11500;26500;15;44;3;29;0;0;1;0
28200;61900;27;63;3;36;0;0;1;0
24500;45000;12;52;3;40;0;0;1;0
53050;61900;45;66;3;21;0;0;1;0
51500;124500;29;55;3;26;0;0;1;0
29000;49500;22;38;3;16;0;0;1;0
22000;64900;15;47;3;32;0;0;1;0
22600;30920;35;42;3;7;0;0;1;0
39000;56500;29;38;3;9;0;0;1;0
26000;59000;35;62;3;27;0;0;1;0
17500;48500;21;54;3;33;0;0;1;0
69500;92000;46;56;3;10;0;0;1;0
45000;101880;30;58;3;28;0;0;1;0
47600;76000;26;38;3;12;0;0;1;0
63000;82700;30;39;3;9;0;0;1;0
20400;43800;8;41;3;33;0;0;1;0
88700;134500;42;61;3;19;0;0;1;0
57900;61000;28;31;3;3;0;0;1;0
30700;54910;37;56;3;19;0;0;1;0
78000;165000;35;51;3;16;0;0;1;0
19900;78650;37;52;3;15;0;0;1;0
37900;41500;40;43;3;3;0;0;1;0
56000;115000;29;63;3;34;0;0;1;0
68500;225000;24;62;3;38;0;0;1;0
23000;29000;22;34;3;12;0;0;1;0
24500;69750;29;56;3;27;0;0;1;0
40400;46100;26;31;3;5;0;0;1;0
29840;29950;43;44;3;1;0;0;1;0
28800;45900;27;39;3;12;0;0;1;0
38500;60000;34;55;3;21;0;0;1;0
11700;36950;8;61;3;53;0;0;1;0
53900;81500;33;43;3;10;0;0;1;0
92500;116500;39;54;3;15;0;0;1;0
13600;19700;8;30;3;22;0;0;1;0
285000;323000;51;63;3;12;0;0;1;0
121000;135000;18;31;3;13;0;0;1;0
53200;120000;30;61;3;31;0;0;1;0
35500;78500;25;61;3;36;0;0;1;0
50500;91900;34;62;3;28;0;0;1;0
91900;106200;55;64;3;9;0;0;1;0
18400;27000;11;30;3;19;0;0;1;0
52500;66000;34;36;3;2;0;0;1;0
68730;89000;53;54;3;1;0;0;1;0
48140;67000;42;58;3;16;0;0;1;0
74000;84000;51;58;3;7;0;0;1;0
53000;58900;56;58;3;2;0;0;1;0
17800;33000;9;36;3;27;0;0;1;0
26900;49000;30;54;3;24;0;0;1;0
38500;81500;27;58;3;31;0;0;1;0
33600;70250;32;61;3;29;0;0;1;0
85000;90000;57;64;3;7;0;0;1;0
53100;83000;39;59;3;20;0;0;1;0
24100;58200;33;43;3;10;0;0;1;0
24900;37000;26;36;3;10;0;0;1;0
32000;76500;16;56;3;40;0;0;1;0
32500;155000;26;57;3;31;0;0;1;0
180000;180000;64;65;3;1;0;0;1;0
60450;76200;42;49;3;7;0;0;1;0
13100;49900;22;56;3;34;0;0;1;0
27900;72000;28;59;3;31;0;0;1;0
42500;84500;24;46;3;22;0;0;1;0
52000;89900;28;42;3;14;0;0;1;0
24200;50800;6;37;3;31;0;0;1;0
71000;124000;37;51;3;14;0;0;1;0
105000;156000;43;59;3;16;0;0;1;0
28000;52000;33;62;3;29;0;0;1;0
31400;71000;27;54;3;27;0;0;1;0
63700;118000;38;66;3;28;0;0;1;0
46700;81000;6;34;3;28;0;0;1;0
54000;89900;34;61;3;27;0;0;1;0
17800;43500;25;52;3;27;0;0;1;0
33900;100000;17;59;3;42;0;0;1;0
63950;65500;44;45;3;1;0;0;1;0
49400;52000;38;39;3;1;0;0;1;0
87900;139900;35;50;3;15;0;0;1;0
55500;110000;25;64;3;39;0;0;1;0
40600;63370;39;58;3;19;0;0;1;0
61500;100000;33;49;3;16;0;0;1;0
60000;62500;17;21;3;4;0;0;1;0
41000;60000;30;38;3;8;0;0;1;0
50000;61970;35;42;3;7;0;0;1;0
34000;115000;8;59;3;51;0;0;1;0
24700;28700;27;31;3;4;0;0;1;0
46500;113000;23;58;3;35;0;0;1;0
92500;94000;61;62;3;1;0;0;1;0
27950;56000;41;63;3;22;0;0;1;0
26000;33000;22;31;3;9;0;0;1;0
35400;52500;38;54;3;16;0;0;1;0
66900;86820;38;57;3;19;0;0;1;0
64900;66340;41;42;3;1;0;0;1;0
35000;54500;29;38;3;9;0;0;1;0
15700;27200;8;35;3;27;0;0;1;0
51400;61330;41;59;3;18;0;0;1;0
39050;46500;43;55;3;12;0;0;1;0
36000;60000;32;44;3;12;0;0;1;0
59500;91500;37;50;3;13;0;0;1;0
33500;39500;14;29;3;15;0;0;1;0
57950;82500;47;60;3;13;0;0;1;0
67900;83900;47;64;3;17;0;0;1;0
68000;262000;14;63;3;49;0;0;1;0
20900;57250;14;56;3;42;0;0;1;0
22000;37500;43;57;3;14;0;0;1;0
75000;79750;43;53;3;10;0;0;1;0
26100;61000;29;58;3;29;0;0;1;0
95000;129900;34;41;3;7;0;0;1;0
64000;77660;49;59;3;10;0;0;1;0
24500;60000;29;47;3;18;0;0;1;0
78000;91000;46;54;3;8;0;0;1;0
15600;34950;30;55;3;25;0;0;1;0
24000;35000;28;35;3;7;0;0;1;0
39150;39500;57;58;3;1;0;0;1;0
35100;62650;32;50;3;18;0;0;1;0
128000;151500;54;64;3;10;0;0;1;0
54500;92500;32;39;3;7;0;0;1;0
168000;335000;37;58;3;21;0;0;1;0
27000;43500;37;54;3;17;0;0;1;0
103000;142500;42;61;3;19;0;0;1;0
76220;116000;42;63;3;21;0;0;1;0
35500;85000;26;61;3;35;0;0;1;0
35000;45000;31;35;3;4;0;0;1;0
38700;96000;26;63;3;37;0;0;1;0
42500;72000;31;42;3;11;0;0;1;0
57200;57850;51;52;3;1;0;0;1;0
27500;68500;35;63;3;28;0;0;1;0
30500;43900;5;39;3;34;0;0;1;0
12000;15700;14;35;3;21;0;0;1;0
27200;74900;9;30;3;21;0;0;1;0
54100;71700;44;53;3;9;0;0;1;0
95950;125000;44;57;3;13;0;0;1;0
65500;86000;40;63;3;23;0;0;1;0
22200;54500;14;39;3;25;0;0;1;0
92500;139000;32;35;3;3;0;0;1;0
129000;185000;39;52;3;13;0;0;1;0
138000;150000;45;52;3;7;0;0;1;0
47950;66000;43;55;3;12;0;0;1;0
73900;92000;42;50;3;8;0;0;1;0
29500;52500;30;56;3;26;0;0;1;0
39000;69000;25;34;3;9;0;0;1;0
12700;29720;19;54;3;35;0;0;1;0
55500;126500;24;54;3;30;0;0;1;0
44900;67950;46;59;3;13;0;0;1;0
20200;26200;15;30;3;15;0;0;1;0
9600;27840;10;42;3;32;0;0;1;0
14500;32540;12;45;3;33;0;0;1;0
48700;69650;35;64;3;29;0;0;1;0
33000;40700;26;33;3;7;0;0;1;0
169500;325000;35;63;3;28;0;0;1;0
35000;84000;29;58;3;29;0;0;1;0
12000;12500;18;19;3;1;0;0;1;0
25500;31000;26;32;3;6;0;0;1;0
30500;97500;29;46;3;17;0;0;1;0
70900;155000;39;48;3;9;0;0;1;0
14900;19900;6;17;3;11;0;0;1;0
24300;45000;31;54;3;23;0;0;1;0
16500;26750;38;55;3;17;0;0;1;0
147000;259000;31;62;3;31;0;0;1;0
24500;46270;31;60;3;29;0;0;1;0
14500;14000;24;25;3;1;0;0;1;0
80000;82500;57;58;3;1;0;0;1;0
19300;35000;28;40;3;12;0;0;1;0
31000;80000;28;58;3;30;0;0;1;0
45400;67800;35;49;3;14;0;0;1;0
14300;47500;16;61;3;45;0;0;1;0
69600;78000;45;54;3;9;0;0;1;0
42900;61000;29;50;3;21;0;0;1;0
92000;118000;39;57;3;18;0;0;1;0
45700;56500;39;43;3;4;0;0;1;0
31600;57500;29;39;3;10;0;0;1;0
32500;71000;18;64;3;46;0;0;1;0
39000;68200;27;35;3;8;0;0;1;0
13800;25800;26;39;3;13;0;0;1;0
109500;139500;47;59;3;12;0;0;1;0
67000;85000;43;62;3;19;0;0;1;0
106000;114900;50;54;3;4;0;0;1;0
89500;158000;36;62;3;26;0;0;1;0
19500;45000;39;61;3;22;0;0;1;0
61300;86000;38;56;3;18;0;0;1;0
67500;49900;45;62;3;17;0;0;1;0
33000;49000;37;49;3;12;0;0;1;0
64000;83540;39;44;3;5;0;0;1;0
49500;63500;14;30;3;16;0;0;1;0
27400;60500;23;60;3;37;0;0;1;0
69900;75900;36;41;3;5;0;0;1;0
12000;25650;31;46;3;15;0;0;1;0
38500;75000;21;47;3;26;0;0;1;0
21900;49900;7;39;3;32;0;0;1;0
20250;28500;46;49;3;3;0;0;1;0
60500;74500;43;57;3;14;0;0;1;0
157500;237000;58;62;3;4;0;0;1;0
87500;159900;26;59;3;33;0;0;1;0
22000;31750;41;45;3;4;0;0;1;0
63500;90500;26;38;3;12;0;0;1;0
59750;64000;48;56;3;8;0;0;1;0
17000;22800;16;32;3;16;0;0;1;0
13100;41410;7;55;3;48;0;0;1;0
28900;48000;21;40;3;19;0;0;1;0
18700;32700;29;42;3;13;0;0;1;0
56400;81000;37;54;3;17;0;0;1;0
33000;77500;6;36;3;30;0;0;1;0
21000;33300;8;39;3;31;0;0;1;0
42500;72000;33;47;3;14;0;0;1;0
87000;92500;49;50;3;1;0;0;1;0
147000;198000;52;61;3;9;0;0;1;0
13000;16200;9;34;3;25;0;0;1;0
14100;29600;26;38;3;12;0;0;1;0
20500;41500;35;62;3;27;0;0;1;0
28000;32500;19;27;3;8;0;0;1;0
51300;57700;16;22;3;6;0;0;1;0
50800;71000;39;57;3;18;0;0;1;0
24500;35000;22;38;3;16;0;0;1;0
54700;78000;41;60;3;19;0;0;1;0
66770;131500;51;61;3;10;0;0;1;0
88830;87380;62;65;3;3;0;0;1;0
40000;57000;31;37;3;6;0;0;1;0
70000;127000;38;58;3;20;0;0;1;0
46400;78000;34;61;3;27;0;0;1;0
11300;14000;9;30;3;21;0;0;1;0
70000;223000;30;59;3;29;0;0;1;0
32500;45000;25;31;3;6;0;0;1;0
53500;107500;27;47;3;20;0;0;1;0
20300;39000;9;31;3;22;0;0;1;0
34000;80300;24;53;3;29;0;0;1;0
214200;238000;62;64;3;2;0;0;1;0
14500;20100;23;33;3;10;0;0;1;0
24000;36750;37;54;3;17;0;0;1;0
53700;54500;41;43;3;2;0;0;1;0
56000;71500;29;34;3;5;0;0;1;0
30000;150000;10;46;3;36;0;0;1;0
55300;75000;39;54;3;15;0;0;1;0
130000;135000;57;63;3;6;0;0;1;0
22300;35000;15;33;3;18;0;0;1;0
25000;36000;41;53;3;12;0;0;1;0
53700;68000;49;65;3;16;0;0;1;0
24800;45000;29;42;3;13;0;0;1;0
13000;19600;26;38;3;12;0;0;1;0
39900;52900;29;37;3;8;0;0;1;0
84000;84000;58;59;3;1;0;0;1;0
43000;55000;24;33;3;9;0;0;1;0
31500;40000;10;23;3;13;0;0;1;0
44900;62000;39;55;3;16;0;0;1;0
47500;59000;25;31;3;6;0;0;1;0
119000;275000;43;60;3;17;0;0;1;0
83500;240000;27;60;3;33;0;0;1;0
21000;26800;11;31;3;20;0;0;1;0
70900;83500;43;64;3;21;0;0;1;0
113500;116500;56;64;3;8;0;0;1;0
28000;41300;25;40;3;15;0;0;1;0
21000;51000;22;65;3;43;0;0;1;0
20000;41000;33;50;3;17;0;0;1;0
19900;27500;15;36;3;21;0;0;1;0
43300;58000;38;51;3;13;0;0;1;0
26900;64000;22;56;3;34;0;0;1;0
58500;106000;39;65;3;26;0;0;1;0
22000;35000;19;35;3;16;0;0;1;0
61950;62950;43;44;3;1;0;0;1;0
32500;34000;37;38;3;1;0;0;1;0
89900;118000;39;52;3;13;0;0;1;0
78500;87000;48;56;3;8;0;0;1;0
74000;74000;46;47;3;1;0;0;1;0
37000;59000;39;65;3;26;0;0;1;0
65000;69700;52;64;3;12;0;0;1;0
32500;33500;31;33;3;2;0;0;1;0
31300;52700;28;39;3;11;0;0;1;0
54300;88000;29;46;3;17;0;0;1;0
26500;29100;7;29;3;22;0;0;1;0
140000;162500;50;61;3;11;0;0;1;0
22500;70000;8;64;3;56;0;0;1;0
87950;90950;46;47;3;1;0;0;1;0
36300;51500;32;41;3;9;0;0;1;0
63950;66950;45;46;3;1;0;0;1;0
47500;62500;35;47;3;12;0;0;1;0
17500;26200;8;35;3;27;0;0;1;0
27100;43880;31;43;3;12;0;0;1;0
35000;38500;18;24;3;6;0;0;1;0
45100;45200;37;38;3;1;0;0;1;0
24200;33300;27;35;3;8;0;0;1;0
36800;112500;11;58;3;47;0;0;1;0
15200;54000;31;61;3;30;0;0;1;0
49500;157000;16;55;3;39;0;0;1;0
17600;68000;9;54;3;45;0;0;1;0
75850;87000;41;50;3;9;0;0;1;0
44800;45000;40;43;3;3;0;0;1;0
52000;68900;49;53;3;4;0;0;1;0
21700;29500;32;39;3;7;0;0;1;0
165000;180000;51;52;3;1;0;0;1;0
25600;50000;29;49;3;20;0;0;1;0
32500;53500;41;64;3;23;0;0;1;0
26700;46200;29;39;3;10;0;0;1;0
61900;91000;47;59;3;12;0;0;1;0
65500;89500;39;52;3;13;0;0;1;0
13300;41500;25;39;3;14;0;0;1;0
119900;164970;39;58;3;19;0;0;1;0
23500;25000;35;37;3;2;0;0;1;0
66300;69950;59;60;3;1;0;0;1;0
57290;58500;51;62;3;11;0;0;1;0
33500;56500;28;40;3;12;0;0;1;0
32000;85000;27;63;3;36;0;0;1;0
30200;62950;24;43;3;19;0;0;1;0
34200;71000;27;46;3;19;0;0;1;0
77500;109500;41;57;3;16;0;0;1;0
123420;135000;54;62;3;8;0;0;1;0
33000;66500;32;64;3;32;0;0;1;0
21700;45930;30;45;3;15;0;0;1;0
23000;49800;17;40;3;23;0;0;1;0
57200;79000;29;36;3;7;0;0;1;0
37600;82900;31;66;3;35;0;0;1;0
62200;103000;40;43;3;3;0;0;1;0
99950;103000;49;60;3;11;0;0;1;0
72500;88000;39;63;3;24;0;0;1;0
53000;110000;25;43;3;18;0;0;1;0
19700;26400;17;30;3;13;0;0;1;0
66050;66900;45;46;3;1;0;0;1;0
42500;48000;6;15;3;9;0;0;1;0
15000;29500;35;45;3;10;0;0;1;0
40000;97500;22;54;3;32;0;0;1;0
50500;85000;31;35;3;4;0;0;1;0
39500;59350;35;48;3;13;0;0;1;0
22400;53000;19;42;3;23;0;0;1;0
96000;141500;35;43;3;8;0;0;1;0
28400;31400;13;14;3;1;0;0;1;0
24500;73900;21;62;3;41;0;0;1;0
24000;32800;17;37;3;20;0;0;1;0
30900;38500;32;36;3;4;0;0;1;0
48800;89000;29;43;3;14;0;0;1;0
52500;67200;30;35;3;5;0;0;1;0
30200;47950;39;57;3;18;0;0;1;0
80500;97300;39;47;3;8;0;0;1;0
65000;138000;30;63;3;33;0;0;1;0
36000;71500;31;46;3;15;0;0;1;0
14400;19400;7;34;3;27;0;0;1;0
14700;26400;31;42;3;11;0;0;1;0
12200;27310;15;43;3;28;0;0;1;0
79000;180000;27;62;3;35;0;0;1;0
42000;53500;25;31;3;6;0;0;1;0
40000;65000;39;51;3;12;0;0;1;0
59030;57500;52;54;3;2;0;0;1;0
89950;110900;44;62;3;18;0;0;1;0
122000;147000;48;57;3;9;0;0;1;0
37000;43900;31;35;3;4;0;0;1;0
36400;47700;28;35;3;7;0;0;1;0
18500;23500;19;31;3;12;0;0;1;0
35400;129750;26;57;3;31;0;0;1;0
14300;34250;29;43;3;14;0;0;1;0
53000;77700;25;36;3;11;0;0;1;0
77500;86000;45;58;3;13;0;0;1;0
58800;75000;43;54;3;11;0;0;1;0
29000;90000;19;66;3;47;0;0;1;0
60000;75900;41;59;3;18;0;0;1;0
90000;101000;56;63;3;7;0;0;1;0
52000;52000;63;64;3;1;0;0;1;0
40000;49000;30;34;3;4;0;0;1;0
66200;125500;31;61;3;30;0;0;1;0
32250;37000;43;57;3;14;0;0;1;0
61700;97450;41;55;3;14;0;0;1;0
25500;60000;31;62;3;31;0;0;1;0
99500;117000;38;48;3;10;0;0;1;0
54000;67500;37;44;3;7;0;0;1;0
40500;49500;33;34;3;1;0;0;1;0
22900;52800;25;58;3;33;0;0;1;0
39500;41500;48;49;3;1;0;0;1;0
25000;25000;30;31;3;1;0;0;1;0
29000;29500;27;28;3;1;0;0;1;0
29700;43600;8;12;3;4;0;0;1;0
25500;48000;29;36;3;7;0;0;1;0
18800;26000;23;32;3;9;0;0;1;0
32500;32500;46;47;3;1;0;0;1;0
30900;76000;29;61;3;32;0;0;1;0
12500;73300;8;60;3;52;0;0;1;0
29900;36200;11;34;3;23;0;0;1;0
12500;34650;27;56;3;29;0;0;1;0
55500;60000;45;64;3;19;0;0;1;0
79900;95000;49;60;3;11;0;0;1;0
43000;110000;30;61;3;31;0;0;1;0
36000;56500;25;32;4;7;0;0;0;1
52500;64000;29;35;4;6;0;0;0;1
23800;140000;1;66;4;65;0;0;0;1
59000;67500;29;34;4;5;0;0;0;1
22500;63000;13;31;4;18;0;0;0;1
43900;52900;30;35;4;5;0;0;0;1
108000;109000;59;60;4;1;0;0;0;1
31500;35700;4;7;4;3;0;0;0;1
47500;72000;24;34;4;10;0;0;0;1
39500;75000;18;27;4;9;0;0;0;1
47100;102000;26;43;4;17;0;0;0;1
34000;42500;4;16;4;12;0;0;0;1
46700;75000;22;32;4;10;0;0;0;1
30500;57000;23;33;4;10;0;0;0;1
72900;120500;36;54;4;18;0;0;0;1
35500;65000;22;34;4;12;0;0;0;1
37200;57500;10;26;4;16;0;0;0;1
22000;42500;13;29;4;16;0;0;0;1
45000;56800;29;35;4;6;0;0;0;1
77900;108000;33;40;4;7;0;0;0;1
32500;33200;5;10;4;5;0;0;0;1
73000;127000;35;64;4;29;0;0;0;1
80500;132500;35;47;4;12;0;0;0;1
49000;51500;14;17;4;3;0;0;0;1
33500;45500;18;28;4;10;0;0;0;1
21000;104000;6;64;4;58;0;0;0;1
30000;47500;14;27;4;13;0;0;0;1
27000;57500;13;35;4;22;0;0;0;1
33000;55000;12;29;4;17;0;0;0;1
71900;120000;34;59;4;25;0;0;0;1
23000;58000;5;27;4;22;0;0;0;1
23000;45000;10;32;4;22;0;0;0;1
30900;45000;4;20;4;16;0;0;0;1
34000;48200;27;30;4;3;0;0;0;1
34000;54000;10;27;4;17;0;0;0;1
44500;68000;8;24;4;16;0;0;0;1
60000;108000;20;32;4;12;0;0;0;1
1400000;1400000;58;59;4;1;0;0;0;1
51500;105000;34;43;4;9;0;0;0;1
46000;96000;14;35;4;21;0;0;0;1
38100;141000;21;66;4;45;0;0;0;1
63000;74700;31;36;4;5;0;0;0;1
42000;51000;26;29;4;3;0;0;0;1
31200;61500;15;32;4;17;0;0;0;1
31600;41600;14;25;4;11;0;0;0;1
22400;55000;5;29;4;24;0;0;0;1
38000;52500;25;29;4;4;0;0;0;1
57900;97000;29;45;4;16;0;0;0;1
120000;139900;48;58;4;10;0;0;0;1
46000;70000;34;45;4;11;0;0;0;1
43000;70000;23;33;4;10;0;0;0;1
55000;85000;46;63;4;17;0;0;0;1
36900;41500;20;22;4;2;0;0;0;1
57500;102000;25;36;4;11;0;0;0;1
100000;156000;36;50;4;14;0;0;0;1
44900;72500;14;30;4;16;0;0;0;1
23500;147000;9;65;4;56;0;0;0;1
37000;135500;11;46;4;35;0;0;0;1
1040000;1040000;58;59;4;1;0;0;0;1
83500;140000;35;56;4;21;0;0;0;1
59000;83500;32;44;4;12;0;0;0;1
38100;96500;8;33;4;25;0;0;0;1
45500;83000;15;29;4;14;0;0;0;1
28000;54500;19;31;4;12;0;0;0;1
30800;31500;12;13;4;1;0;0;0;1
850000;810000;57;58;4;1;0;0;0;1
66000;117500;26;35;4;9;0;0;0;1
56700;68600;27;29;4;2;0;0;0;1
43500;66000;26;34;4;8;0;0;0;1
23300;42500;21;30;4;9;0;0;0;1
27900;38900;19;27;4;8;0;0;0;1
17500;29500;11;25;4;14;0;0;0;1
35500;40000;16;19;4;3;0;0;0;1
49500;67500;28;33;4;5;0;0;0;1
31900;52500;17;32;4;15;0;0;0;1
28200;41500;12;24;4;12;0;0;0;1
38100;57000;27;32;4;5;0;0;0;1
20000;44900;7;28;4;21;0;0;0;1
60000;124000;27;56;4;29;0;0;0;1
36500;55000;17;26;4;9;0;0;0;1
61500;107500;13;29;4;16;0;0;0;1
47500;141000;17;53;4;36;0;0;0;1
28000;75000;23;41;4;18;0;0;0;1
109000;200000;32;59;4;27;0;0;0;1
42900;70000;17;33;4;16;0;0;0;1
49900;135000;28;58;4;30;0;0;0;1
130000;158000;47;61;4;14;0;0;0;1
30000;43000;14;23;4;9;0;0;0;1
52000;104000;33;64;4;31;0;0;0;1
28500;42000;13;26;4;13;0;0;0;1
38500;65500;1;26;4;25;0;0;0;1
24000;95000;5;58;4;53;0;0;0;1
40000;62000;13;28;4;15;0;0;0;1
24500;55000;14;33;4;19;0;0;0;1
38000;126500;18;65;4;47;0;0;0;1
127000;150000;27;31;4;4;0;0;0;1
66900;120000;27;43;4;16;0;0;0;1
900000;895000;46;56;4;10;0;0;0;1
18500;49000;8;36;4;28;0;0;0;1
34500;60000;14;25;4;11;0;0;0;1
40000;69500;10;26;4;16;0;0;0;1
34900;46000;13;25;4;12;0;0;0;1
60000;84500;40;44;4;4;0;0;0;1
21500;36000;5;33;4;28;0;0;0;1
21500;77900;7;64;4;57;0;0;0;1
43000;73500;23;33;4;10;0;0;0;1
33000;49500;12;26;4;14;0;0;0;1
79000;129000;33;61;4;28;0;0;0;1
1230000;1230000;65;66;4;1;0;0;0;1
1190000;1190000;55;56;4;1;0;0;0;1
45000;80000;31;58;4;27;0;0;0;1
28200;36000;1;4;4;3;0;0;0;1
42000;53000;18;22;4;4;0;0;0;1
27300;75000;5;30;4;25;0;0;0;1
69000;89000;27;35;4;8;0;0;0;1
59000;95500;33;48;4;15;0;0;0;1
69500;70000;31;34;4;3;0;0;0;1
75000;173000;29;61;4;32;0;0;0;1
39500;54000;22;28;4;6;0;0;0;1
110000;220000;33;53;4;20;0;0;0;1
27500;35200;10;27;4;17;0;0;0;1
71000;198000;28;66;4;38;0;0;0;1
27000;89200;20;57;4;37;0;0;0;1
29500;70000;9;31;4;22;0;0;0;1
67000;97500;26;34;4;8;0;0;0;1
23200;28600;1;10;4;9;0;0;0;1
31000;55000;18;32;4;14;0;0;0;1
15800;32000;13;27;4;14;0;0;0;1
52600;70000;28;33;4;5;0;0;0;1
24700;98500;5;60;4;55;0;0;0;1
27000;85000;9;36;4;27;0;0;0;1
47900;58500;29;36;4;7;0;0;0;1
26900;57000;1;29;4;28;0;0;0;1
29800;51000;19;31;4;12;0;0;0;1
62900;78000;27;30;4;3;0;0;0;1
62000;97500;33;55;4;22;0;0;0;1
92000;108000;46;55;4;9;0;0;0;1
110000;210000;30;46;4;16;0;0;0;1
760000;742000;60;61;4;1;0;0;0;1
33000;54000;26;33;4;7;0;0;0;1
25000;35500;15;22;4;7;0;0;0;1
125000;500000;25;54;4;29;0;0;0;1
35900;123500;18;57;4;39;0;0;0;1
39000;105500;23;56;4;33;0;0;0;1
325000;325000;14;15;4;1;0;0;0;1
1125000;1125000;56;57;4;1;0;0;0;1
44500;55900;27;30;4;3;0;0;0;1
1051000;1050000;57;58;4;1;0;0;0;1
30200;44700;26;33;4;7;0;0;0;1
18500;45400;14;32;4;18;0;0;0;1
39900;72500;23;33;4;10;0;0;0;1
36700;72000;7;30;4;23;0;0;0;1
28000;42500;17;26;4;9;0;0;0;1
29800;58000;11;30;4;19;0;0;0;1
72500;140000;28;56;4;28;0;0;0;1
28000;62500;18;36;4;18;0;0;0;1
31000;53200;9;27;4;18;0;0;0;1
26500;55000;13;33;4;20;0;0;0;1
29000;47500;16;26;4;10;0;0;0;1
46000;88000;4;28;4;24;0;0;0;1
53700;65500;22;27;4;5;0;0;0;1
75900;80400;34;35;4;1;0;0;0;1
30000;36500;6;17;4;11;0;0;0;1
132500;188000;35;67;4;32;0;0;0;1
230000;215000;7;13;4;6;0;0;0;1
66500;135000;31;58;4;27;0;0;0;1
32500;44000;28;33;4;5;0;0;0;1
31000;47900;20;29;4;9;0;0;0;1
32900;35000;11;20;4;9;0;0;0;1
49700;155000;5;64;4;59;0;0;0;1
63000;99500;29;33;4;4;0;0;0;1
31300;52000;26;31;4;5;0;0;0;1
31500;59600;13;29;4;16;0;0;0;1
140000;280000;35;65;4;30;0;0;0;1
22000;53900;7;30;4;23;0;0;0;1
39900;43100;6;12;4;6;0;0;0;1
35000;44000;12;19;4;7;0;0;0;1
36200;43000;10;21;4;11;0;0;0;1
35500;88000;27;62;4;35;0;0;0;1
17000;92500;12;65;4;53;0;0;0;1
23200;30700;16;25;4;9;0;0;0;1
37500;59900;15;29;4;14;0;0;0;1
81000;134000;33;55;4;22;0;0;0;1
142000;163000;59;67;4;8;0;0;0;1
43000;47000;23;28;4;5;0;0;0;1
73000;89000;28;30;4;2;0;0;0;1
36500;50900;27;31;4;4;0;0;0;1
113000;141000;54;65;4;11;0;0;0;1
45500;73900;23;37;4;14;0;0;0;1
34500;46000;11;22;4;11;0;0;0;1
41500;54000;16;24;4;8;0;0;0;1
30000;37000;8;13;4;5;0;0;0;1
49500;57000;13;17;4;4;0;0;0;1
1460000;1380000;47;56;4;9;0;0;0;1
29500;41500;13;22;4;9;0;0;0;1
33500;39500;6;16;4;10;0;0;0;1
38000;40200;9;11;4;2;0;0;0;1
80000;92900;25;29;4;4;0;0;0;1
115000;285000;24;56;4;32;0;0;0;1
65500;71000;31;36;4;5;0;0;0;1
57500;73500;27;30;4;3;0;0;0;1
47500;60000;11;18;4;7;0;0;0;1
48500;58000;16;20;4;4;0;0;0;1
41500;59500;7;25;4;18;0;0;0;1
30000;73900;10;32;4;22;0;0;0;1
125900;142000;60;65;4;5;0;0;0;1
96000;136500;28;35;4;7;0;0;0;1
74000;114000;6;24;4;18;0;0;0;1
52000;150000;23;53;4;30;0;0;0;1
45000;120000;22;45;4;23;0;0;0;1
63500;72000;28;29;4;1;0;0;0;1
45000;46200;7;10;4;3;0;0;0;1
28600;42000;15;25;4;10;0;0;0;1
31700;142900;11;67;4;56;0;0;0;1
350000;340000;6;11;4;5;0;0;0;1
32500;102000;12;58;4;46;0;0;0;1
45000;61900;28;31;4;3;0;0;0;1
23500;28900;12;17;4;5;0;0;0;1
47200;145000;23;60;4;37;0;0;0;1
22000;48200;22;30;4;8;0;0;0;1
67100;152000;27;43;4;16;0;0;0;1
22500;50000;22;36;4;14;0;0;0;1
108000;109900;59;60;4;1;0;0;0;1
41500;140000;22;66;4;44;0;0;0;1
23500;99000;15;66;4;51;0;0;0;1
44000;156000;22;65;4;43;0;0;0;1
45000;49900;22;25;4;3;0;0;0;1
33700;47000;6;21;4;15;0;0;0;1
21800;90000;6;61;4;55;0;0;0;1
34000;43500;22;26;4;4;0;0;0;1
74900;170000;25;43;4;18;0;0;0;1
47000;63900;24;30;4;6;0;0;0;1
32000;45000;25;30;4;5;0;0;0;1
46500;49500;11;13;4;2;0;0;0;1
38800;53500;13;25;4;12;0;0;0;1
36000;47200;11;21;4;10;0;0;0;1
130000;140500;58;64;4;6;0;0;0;1
79000;130000;34;45;4;11;0;0;0;1
65900;108000;24;33;4;9;0;0;0;1
49000;75000;27;32;4;5;0;0;0;1
37600;94400;20;62;4;42;0;0;0;1
51900;103000;27;55;4;28;0;0;0;1
38600;45900;17;26;4;9;0;0;0;1
36000;49000;25;32;4;7;0;0;0;1
23000;30500;20;33;4;13;0;0;0;1
71200;76000;15;19;4;4;0;0;0;1
25000;35700;2;17;4;15;0;0;0;1
35500;60500;25;34;4;9;0;0;0;1
27000;136500;21;62;4;41;0;0;0;1
21700;33500;6;27;4;21;0;0;0;1
112000;136900;53;62;4;9;0;0;0;1
40900;46700;24;27;4;3;0;0;0;1
62000;66000;32;35;4;3;0;0;0;1
32500;37500;6;13;4;7;0;0;0;1
68200;79000;26;30;4;4;0;0;0;1
36200;41000;9;15;4;6;0;0;0;1
52000;55000;43;64;4;21;0;0;0;1
42000;61900;6;18;4;12;0;0;0;1
78000;79500;45;57;4;12;0;0;0;1
30900;67000;16;35;4;19;0;0;0;1
33500;90000;5;31;4;26;0;0;0;1
269000;219000;8;17;4;9;0;0;0;1
1150000;1150000;57;58;4;1;0;0;0;1
23400;26100;10;22;4;12;0;0;0;1
64000;89800;21;26;4;5;0;0;0;1
132500;230000;31;58;4;27;0;0;0;1
28000;117000;4;45;4;41;0;0;0;1
30000;30900;11;14;4;3;0;0;0;1
36000;62500;14;30;4;16;0;0;0;1
31900;44900;14;25;4;11;0;0;0;1
67900;90000;27;33;4;6;0;0;0;1
163500;189000;58;65;4;7;0;0;0;1
24500;56000;14;33;4;19;0;0;0;1
27000;31000;1;11;4;10;0;0;0;1
24000;45500;3;26;4;23;0;0;0;1
60000;116500;29;56;4;27;0;0;0;1
134000;178000;51;65;4;14;0;0;0;1
31000;53800;21;31;4;10;0;0;0;1
30900;121500;23;45;4;22;0;0;0;1
55900;115000;30;64;4;34;0;0;0;1
28500;58000;16;32;4;16;0;0;0;1
44000;222500;12;67;4;55;0;0;0;1
96000;169000;35;46;4;11;0;0;0;1
1450000;1450000;59;60;4;1;0;0;0;1
32000;107000;9;43;4;34;0;0;0;1
126900;127000;59;60;4;1;0;0;0;1
460000;460000;21;22;4;1;0;0;0;1
45000;72000;31;59;4;28;0;0;0;1
25100;61000;5;33;4;28;0;0;0;1
49000;95500;32;65;4;33;0;0;0;1
42500;80000;20;30;4;10;0;0;0;1
37000;38500;8;11;4;3;0;0;0;1
83000;112000;31;44;4;13;0;0;0;1
43000;50000;17;23;4;6;0;0;0;1
11500;22500;1;19;4;18;0;0;0;1
24700;45000;22;34;4;12;0;0;0;1
59500;77000;29;31;4;2;0;0;0;1
61500;73000;29;34;4;5;0;0;0;1
52000;140000;16;35;4;19;0;0;0;1
24500;72900;9;39;4;30;0;0;0;1
77000;120000;35;47;4;12;0;0;0;1
48700;72500;26;32;4;6;0;0;0;1
46700;64000;10;22;4;12;0;0;0;1
28500;30500;9;16;4;7;0;0;0;1
2500000;2450000;45;47;4;2;0;0;0;1
65000;84000;17;27;4;10;0;0;0;1
36700;75000;6;27;4;21;0;0;0;1
62400;175000;26;62;4;36;0;0;0;1
61400;99000;25;34;4;9;0;0;0;1
1209000;1209000;57;58;4;1;0;0;0;1
19800;30700;6;23;4;17;0;0;0;1
50000;78000;23;34;4;11;0;0;0;1
28900;70500;9;34;4;25;0;0;0;1
442000;440000;11;17;4;6;0;0;0;1
76000;147500;29;46;4;17;0;0;0;1
41000;43500;6;11;4;5;0;0;0;1
24900;57900;12;30;4;18;0;0;0;1
59400;142000;26;46;4;20;0;0;0;1
24000;71200;7;34;4;27;0;0;0;1
35900;43000;24;28;4;4;0;0;0;1
109600;200000;32;43;4;11;0;0;0;1
79000;149500;34;65;4;31;0;0;0;1
18700;69500;10;40;4;30;0;0;0;1
33500;94000;6;34;4;28;0;0;0;1
57600;129000;25;56;4;31;0;0;0;1
110000;145000;45;63;4;18;0;0;0;1
82700;162000;35;65;4;30;0;0;0;1
74000;124000;29;43;4;14;0;0;0;1
48000;110000;27;55;4;28;0;0;0;1
52500;69500;21;26;4;5;0;0;0;1
38500;63900;22;34;4;12;0;0;0;1
80500;154000;30;51;4;21;0;0;0;1
49900;67500;23;31;4;8;0;0;0;1
20000;28000;13;22;4;9;0;0;0;1
199000;199000;11;12;4;1;0;0;0;1
55900;91500;25;36;4;11;0;0;0;1
23900;29200;26;28;4;2;0;0;0;1
44900;78500;9;28;4;19;0;0;0;1
85000;115000;27;33;4;6;0;0;0;1
29200;43500;18;28;4;10;0;0;0;1
42200;66500;16;29;4;13;0;0;0;1
42000;61500;15;26;4;11;0;0;0;1
42900;45000;18;20;4;2;0;0;0;1
52000;106500;28;51;4;23;0;0;0;1
15500;25000;32;33;4;1;0;0;0;1
42500;58000;12;25;4;13;0;0;0;1
43500;106500;27;56;4;29;0;0;0;1
22900;40000;7;28;4;21;0;0;0;1
72700;112000;24;31;4;7;0;0;0;1
23500;85000;25;64;4;39;0;0;0;1
39900;50000;19;22;4;3;0;0;0;1
86500;91000;34;36;4;2;0;0;0;1
127500;205000;35;60;4;25;0;0;0;1
24300;41000;24;33;4;9;0;0;0;1
63900;90000;28;33;4;5;0;0;0;1
28000;58000;10;34;4;24;0;0;0;1
68500;135900;31;57;4;26;0;0;0;1
36200;62900;11;22;4;11;0;0;0;1
80000;105000;43;50;4;7;0;0;0;1
56000;86500;23;31;4;8;0;0;0;1
59500;165000;23;62;4;39;0;0;0;1
64000;89900;21;27;4;6;0;0;0;1
24000;64000;21;35;4;14;0;0;0;1
22500;41000;8;26;4;18;0;0;0;1
46000;64500;28;33;4;5;0;0;0;1
64200;105000;29;53;4;24;0;0;0;1
49500;65500;22;29;4;7;0;0;0;1
48000;59900;28;32;4;4;0;0;0;1
27300;55700;21;35;4;14;0;0;0;1
20000;67500;13;46;4;33;0;0;0;1
40100;41500;22;23;4;1;0;0;0;1
28600;66000;19;56;4;37;0;0;0;1
35500;46100;20;27;4;7;0;0;0;1
22500;29000;12;18;4;6;0;0;0;1
41900;127200;20;56;4;36;0;0;0;1
38500;110000;14;55;4;41;0;0;0;1
55900;68500;29;35;4;6;0;0;0;1
1230000;1230000;55;56;4;1;0;0;0;1
46000;128500;23;58;4;35;0;0;0;1
56500;68900;25;28;4;3;0;0;0;1
37500;79000;15;30;4;15;0;0;0;1
89000;220000;28;45;4;17;0;0;0;1
24500;36500;10;22;4;12;0;0;0;1
28800;75000;22;45;4;23;0;0;0;1
22500;26600;7;21;4;14;0;0;0;1
108000;115000;31;32;4;1;0;0;0;1
24100;25800;14;16;4;2;0;0;0;1
36000;43000;18;26;4;8;0;0;0;1
40900;53900;22;29;4;7;0;0;0;1
425000;410000;7;10;4;3;0;0;0;1
43500;46000;27;28;4;1;0;0;0;1
71000;117000;35;60;4;25;0;0;0;1
50400;154500;29;60;4;31;0;0;0;1
34500;46000;14;26;4;12;0;0;0;1
58000;78500;32;42;4;10;0;0;0;1
113000;114000;46;57;4;11;0;0;0;1
48000;55700;31;34;4;3;0;0;0;1
50000;117000;29;57;4;28;0;0;0;1
1170000;1170000;60;61;4;1;0;0;0;1
25500;44000;27;35;4;8;0;0;0;1
44200;49000;15;21;4;6;0;0;0;1
56200;75000;56;60;4;4;0;0;0;1
64500;90900;33;52;4;19;0;0;0;1
1570000;1570000;57;58;4;1;0;0;0;1
41000;59000;27;30;4;3;0;0;0;1
41000;46500;23;27;4;4;0;0;0;1
175000;189900;59;62;4;3;0;0;0;1
44500;57500;22;26;4;4;0;0;0;1
41100;120000;20;62;4;42;0;0;0;1
42000;82900;30;48;4;18;0;0;0;1
45000;74000;7;28;4;21;0;0;0;1
74900;96000;27;31;4;4;0;0;0;1
38200;44500;12;19;4;7;0;0;0;1
43200;76500;19;31;4;12;0;0;0;1
33500;132000;15;63;4;48;0;0;0;1
69600;125000;33;55;4;22;0;0;0;1
35000;53000;25;31;4;6;0;0;0;1
59900;78000;27;32;4;5;0;0;0;1
67000;92000;27;33;4;6;0;0;0;1
65500;82500;28;34;4;6;0;0;0;1
82000;114900;31;43;4;12;0;0;0;1
30200;41500;22;30;4;8;0;0;0;1
65000;107000;32;49;4;17;0;0;0;1
14500;18000;11;31;4;20;0;0;0;1
54500;78000;26;35;4;9;0;0;0;1
121000;134000;54;61;4;7;0;0;0;1
54000;108700;18;34;4;16;0;0;0;1
19900;29500;4;23;4;19;0;0;0;1
44000;95000;20;34;4;14;0;0;0;1
46000;72000;18;27;4;9;0;0;0;1
45000;72500;16;27;4;11;0;0;0;1
37500;53500;25;32;4;7;0;0;0;1
44500;70000;13;27;4;14;0;0;0;1
57500;95000;13;22;4;9;0;0;0;1
47500;103900;18;35;4;17;0;0;0;1
52000;132500;25;56;4;31;0;0;0;1
50300;140000;33;66;4;33;0;0;0;1
182000;185000;49;56;4;7;0;0;0;1
150000;165000;47;52;4;5;0;0;0;1
34500;55000;4;27;4;23;0;0;0;1
39000;137000;11;56;4;45;0;0;0;1
39500;97000;35;63;4;28;0;0;0;1
68000;191500;26;62;4;36;0;0;0;1
61900;94000;35;58;4;23;0;0;0;1
24700;54500;24;43;4;19;0;0;0;1
39500;100500;9;31;4;22;0;0;0;1
62500;86000;36;45;4;9;0;0;0;1
48000;82500;25;34;4;9;0;0;0;1
25900;32000;9;21;4;12;0;0;0;1
31400;33500;4;11;4;7;0;0;0;1
46000;52000;27;29;4;2;0;0;0;1
167500;170000;57;59;4;2;0;0;0;1
110300;120000;42;45;4;3;0;0;0;1
25300;36900;4;23;4;19;0;0;0;1
45900;55900;24;28;4;4;0;0;0;1
42500;56500;28;36;4;8;0;0;0;1
22700;55000;14;32;4;18;0;0;0;1
41000;87000;6;31;4;25;0;0;0;1
65000;200000;18;58;4;40;0;0;0;1
26000;75000;7;36;4;29;0;0;0;1
52000;77500;22;29;4;7;0;0;0;1
32500;87000;4;30;4;26;0;0;0;1
121400;155000;57;67;4;10;0;0;0;1
58500;152000;28;67;4;39;0;0;0;1
32500;54400;18;31;4;13;0;0;0;1
1950000;1830000;48;55;4;7;0;0;0;1
32500;38500;7;16;4;9;0;0;0;1
59000;192000;19;64;4;45;0;0;0;1
28700;39000;15;26;4;11;0;0;0;1
48900;56900;30;33;4;3;0;0;0;1
108900;116000;55;64;4;9;0;0;0;1
46500;51700;14;17;4;3;0;0;0;1
15900;23500;4;25;4;21;0;0;0;1
102500;103000;32;33;4;1;0;0;0;1
58400;89600;26;35;4;9;0;0;0;1
39000;61000;26;36;4;10;0;0;0;1
69500;115000;32;43;4;11;0;0;0;1
33500;99500;26;59;4;33;0;0;0;1
25600;45000;7;28;4;21;0;0;0;1
40400;128000;25;58;4;33;0;0;0;1
43500;109000;25;57;4;32;0;0;0;1
32000;103000;10;43;4;33;0;0;0;1
39000;49000;13;21;4;8;0;0;0;1
35600;57500;7;23;4;16;0;0;0;1
17500;39900;1;29;4;28;0;0;0;1
32500;40500;14;22;4;8;0;0;0;1
54000;79000;33;42;4;9;0;0;0;1
38000;46500;29;30;4;1;0;0;0;1
35000;53500;26;33;4;7;0;0;0;1
40900;126000;23;60;4;37;0;0;0;1
45800;104500;14;39;4;25;0;0;0;1
54100;55500;32;33;4;1;0;0;0;1
21800;28700;3;13;4;10;0;0;0;1
44000;93000;13;32;4;19;0;0;0;1
14600;61000;35;58;4;23;0;0;0;1
32600;74700;6;30;4;24;0;0;0;1
56700;136500;27;48;4;21;0;0;0;1
35500;50000;28;33;4;5;0;0;0;1
51900;64500;32;34;4;2;0;0;0;1
43000;59500;3;10;4;7;0;0;0;1
39000;167500;5;44;4;39;0;0;0;1
25700;47500;6;28;4;22;0;0;0;1
39900;66500;23;31;4;8;0;0;0;1
18000;23000;6;18;4;12;0;0;0;1
23500;38900;15;29;4;14;0;0;0;1
39900;98500;27;61;4;34;0;0;0;1
71500;85000;30;35;4;5;0;0;0;1
47500;63000;26;30;4;4;0;0;0;1
41500;46200;9;14;4;5;0;0;0;1
53500;87000;25;32;4;7;0;0;0;1
34500;116000;18;57;4;39;0;0;0;1
66000;114000;30;58;4;28;0;0;0;1
39000;42500;13;22;4;9;0;0;0;1
28200;56000;7;28;4;21;0;0;0;1
45000;140000;24;57;4;33;0;0;0;1
44900;64500;16;28;4;12;0;0;0;1
28500;35000;26;33;4;7;0;0;0;1
116000;199000;59;63;4;4;0;0;0;1
46900;97000;28;55;4;27;0;0;0;1
27900;28000;19;20;4;1;0;0;0;1
870000;839000;48;52;4;4;0;0;0;1
81000;148500;35;64;4;29;0;0;0;1
51700;155000;20;45;4;25;0;0;0;1
130000;131000;49;54;4;5;0;0;0;1
25600;56900;9;32;4;23;0;0;0;1
32600;54000;7;26;4;19;0;0;0;1
36000;67900;20;34;4;14;0;0;0;1
55100;120000;30;55;4;25;0;0;0;1
38500;47500;5;14;4;9;0;0;0;1
89000;121000;44;64;4;20;0;0;0;1
33500;36500;19;23;4;4;0;0;0;1
69500;109500;34;47;4;13;0;0;0;1
73800;94000;25;31;4;6;0;0;0;1
41900;43400;23;25;4;2;0;0;0;1
47000;71000;27;36;4;9;0;0;0;1
25000;39500;27;44;4;17;0;0;0;1
36200;84800;7;30;4;23;0;0;0;1
59500;189000;18;45;4;27;0;0;0;1
33500;53900;28;34;4;6;0;0;0;1
23300;41000;7;27;4;20;0;0;0;1
34000;41900;8;18;4;10;0;0;0;1
30500;53000;15;29;4;14;0;0;0;1
54000;87500;33;57;4;24;0;0;0;1
105900;107200;43;45;4;2;0;0;0;1
54200;115000;2;24;4;22;0;0;0;1
65000;105000;35;44;4;9;0;0;0;1
38500;46300;22;24;4;2;0;0;0;1
22500;48000;23;50;4;27;0;0;0;1
20400;116000;1;64;4;63;0;0;0;1
35000;44500;19;24;4;5;0;0;0;1
45000;56000;23;28;4;5;0;0;0;1
35000;55000;25;32;4;7;0;0;0;1
23000;59900;4;34;4;30;0;0;0;1
119500;200000;34;46;4;12;0;0;0;1
45000;121000;26;62;4;36;0;0;0;1
40000;79000;7;25;4;18;0;0;0;1
38500;63000;18;30;4;12;0;0;0;1
60000;157000;21;58;4;37;0;0;0;1
24500;32000;16;27;4;11;0;0;0;1
37700;97700;4;35;4;31;0;0;0;1
42600;49000;32;34;4;2;0;0;0;1
46900;56500;20;26;4;6;0;0;0;1
32000;48500;28;34;4;6;0;0;0;1
23200;54500;2;33;4;31;0;0;0;1
20700;37200;6;32;4;26;0;0;0;1
72500;95000;35;46;4;11;0;0;0;1
125000;187500;34;55;4;21;0;0;0;1
44500;49000;31;36;4;5;0;0;0;1
49000;73000;26;34;4;8;0;0;0;1
23100;64500;14;34;4;20;0;0;0;1
21500;28500;13;27;4;14;0;0;0;1
39700;55900;28;32;4;4;0;0;0;1
49500;118000;12;30;4;18;0;0;0;1
35000;78000;5;30;4;25;0;0;0;1
45800;60000;25;32;4;7;0;0;0;1
17000;18500;7;25;4;18;0;0;0;1
95900;96000;60;61;4;1;0;0;0;1
39900;62000;24;32;4;8;0;0;0;1
43000;65500;18;30;4;12;0;0;0;1
38700;77000;16;29;4;13;0;0;0;1
35500;65000;20;36;4;16;0;0;0;1
34500;66000;25;31;4;6;0;0;0;1
29800;34000;8;12;4;4;0;0;0;1
27000;93000;9;60;4;51;0;0;0;1
50200;119000;27;54;4;27;0;0;0;1
51000;70500;26;36;4;10;0;0;0;1
45500;77000;17;29;4;12;0;0;0;1
31000;128000;13;47;4;34;0;0;0;1
83500;125000;29;35;4;6;0;0;0;1
27600;33000;5;12;4;7;0;0;0;1
58000;72500;29;34;4;5;0;0;0;1
65000;88600;38;51;4;13;0;0;0;1
26600;47000;9;29;4;20;0;0;0;1
41900;63500;18;28;4;10;0;0;0;1
34900;46900;12;22;4;10;0;0;0;1
67500;110000;32;58;4;26;0;0;0;1
1660000;1620000;62;63;4;1;0;0;0;1
38900;58000;18;27;4;9;0;0;0;1
23200;58900;5;34;4;29;0;0;0;1
30000;65500;18;34;4;16;0;0;0;1
56000;64500;22;27;4;5;0;0;0;1
68500;103500;21;31;4;10;0;0;0;1
33000;51000;24;29;4;5;0;0;0;1
91600;143500;32;50;4;18;0;0;0;1
93000;107500;30;35;4;5;0;0;0;1
20000;85000;16;42;4;26;0;0;0;1
58000;102000;33;49;4;16;0;0;0;1
66000;70000;26;30;4;4;0;0;0;1
44700;68500;24;26;4;2;0;0;0;1
97000;197000;31;56;4;25;0;0;0;1
39500;94500;20;42;4;22;0;0;0;1
51000;82700;24;35;4;11;0;0;0;1
45000;139500;24;62;4;38;0;0;0;1
52300;68500;15;23;4;8;0;0;0;1
25000;41000;2;23;4;21;0;0;0;1
86200;172000;35;59;4;24;0;0;0;1
194700;234000;42;54;4;12;0;0;0;1
130000;131500;44;45;4;1;0;0;0;1
34500;80000;13;33;4;20;0;0;0;1
107900;129500;43;56;4;13;0;0;0;1
25500;27500;7;16;4;9;0;0;0;1
49000;226000;10;57;4;47;0;0;0;1
28500;32500;14;20;4;6;0;0;0;1
36000;41500;26;29;4;3;0;0;0;1
45500;75000;20;34;4;14;0;0;0;1
52700;94000;30;56;4;26;0;0;0;1
22500;50000;5;35;4;30;0;0;0;1
43000;53000;12;19;4;7;0;0;0;1
68500;96900;24;35;4;11;0;0;0;1
1950000;1950000;49;62;4;13;0;0;0;1
85000;103000;27;31;4;4;0;0;0;1
86500;160000;26;32;4;6;0;0;0;1
45000;53600;21;26;4;5;0;0;0;1
31900;42700;10;24;4;14;0;0;0;1
31500;61900;8;28;4;20;0;0;0;1
50000;60500;18;23;4;5;0;0;0;1
69000;85900;35;42;4;7;0;0;0;1
49000;54000;18;25;4;7;0;0;0;1
29500;67200;10;32;4;22;0;0;0;1
36300;85000;14;35;4;21;0;0;0;1
25100;57500;18;31;4;13;0;0;0;1
53700;95000;24;31;4;7;0;0;0;1
21500;48000;7;26;4;19;0;0;0;1
31500;94500;8;34;4;26;0;0;0;1
46500;69700;17;29;4;12;0;0;0;1
38000;46000;29;32;4;3;0;0;0;1
126000;133000;59;67;4;8;0;0;0;1
94200;159000;34;59;4;25;0;0;0;1
64000;101900;30;43;4;13;0;0;0;1
45900;92000;28;52;4;24;0;0;0;1
95000;104000;30;33;4;3;0;0;0;1
45000;100000;27;53;4;26;0;0;0;1
62000;89500;27;35;4;8;0;0;0;1
38000;46000;6;15;4;9;0;0;0;1
24000;39500;4;23;4;19;0;0;0;1
71000;74000;21;28;4;7;0;0;0;1
62000;92200;36;43;4;7;0;0;0;1
65900;100000;34;52;4;18;0;0;0;1
68000;100000;35;61;4;26;0;0;0;1
76500;85000;24;27;4;3;0;0;0;1
23500;62500;4;36;4;32;0;0;0;1
45000;69000;15;27;4;12;0;0;0;1
25400;52000;12;33;4;21;0;0;0;1
35500;44900;16;21;4;5;0;0;0;1
71000;119000;35;60;4;25;0;0;0;1
67500;80000;29;35;4;6;0;0;0;1
32900;45000;15;23;4;8;0;0;0;1
37000;38300;16;17;4;1;0;0;0;1
42900;61000;16;27;4;11;0;0;0;1
33400;47000;29;35;4;6;0;0;0;1
48000;71000;22;31;4;9;0;0;0;1
445000;445000;18;19;4;1;0;0;0;1
29900;30000;8;10;4;2;0;0;0;1
58000;78300;27;34;4;7;0;0;0;1
39100;72500;10;28;4;18;0;0;0;1
37500;44000;13;17;4;4;0;0;0;1
88000;108000;54;64;4;10;0;0;0;1
36400;155900;7;44;4;37;0;0;0;1
38200;42000;17;21;4;4;0;0;0;1
38500;40000;10;16;4;6;0;0;0;1
42900;128000;22;66;4;44;0;0;0;1
33500;72500;12;37;4;25;0;0;0;1
49000;80000;35;47;4;12;0;0;0;1
26900;33300;23;25;4;2;0;0;0;1
61000;72000;28;30;4;2;0;0;0;1
32000;44000;25;32;4;7;0;0;0;1
63500;99500;32;55;4;23;0;0;0;1
28500;42500;8;24;4;16;0;0;0;1
45200;132000;25;63;4;38;0;0;0;1
47500;67500;27;30;4;3;0;0;0;1
35500;60000;24;31;4;7;0;0;0;1
29900;34500;8;12;4;4;0;0;0;1
32000;109500;13;57;4;44;0;0;0;1
28900;34000;12;17;4;5;0;0;0;1
38000;51500;28;34;4;6;0;0;0;1
39500;86000;22;34;4;12;0;0;0;1
32500;59700;18;34;4;16;0;0;0;1
25800;94000;26;43;4;17;0;0;0;1
24200;27000;1;7;4;6;0;0;0;1
140000;167000;46;62;4;16;0;0;0;1
117300;130800;45;65;4;20;0;0;0;1
24400;42700;5;27;4;22;0;0;0;1
32900;39300;5;13;4;8;0;0;0;1
40700;64900;25;35;4;10;0;0;0;1
73000;124500;26;36;4;10;0;0;0;1
36000;57000;25;33;4;8;0;0;0;1
45000;63500;25;29;4;4;0;0;0;1
48000;92000;33;46;4;13;0;0;0;1
37900;39500;11;16;4;5;0;0;0;1
25800;35500;16;29;4;13;0;0;0;1
24500;26000;9;19;4;10;0;0;0;1
1660000;1635000;43;45;4;2;0;0;0;1
55600;71000;29;34;4;5;0;0;0;1
269900;299000;44;65;4;21;0;0;0;1
37500;42500;18;25;4;7;0;0;0;1
35800;108000;24;61;4;37;0;0;0;1
42000;57400;28;35;4;7;0;0;0;1
49000;71500;22;30;4;8;0;0;0;1
43700;69500;10;24;4;14;0;0;0;1
63500;81500;28;31;4;3;0;0;0;1
31500;42900;14;25;4;11;0;0;0;1
41000;91000;26;45;4;19;0;0;0;1
17500;28500;5;25;4;20;0;0;0;1
39900;54000;26;34;4;8;0;0;0;1
34000;48000;11;24;4;13;0;0;0;1
20500;25300;4;17;4;13;0;0;0;1
45000;94000;17;33;4;16;0;0;0;1
87200;87500;56;57;4;1;0;0;0;1
28000;68500;18;34;4;16;0;0;0;1
34900;35000;25;27;4;2;0;0;0;1
20600;27500;11;17;4;6;0;0;0;1
53500;159900;18;55;4;37;0;0;0;1
45900;58000;25;29;4;4;0;0;0;1
64900;70900;32;34;4;2;0;0;0;1
36000;48000;19;26;4;7;0;0;0;1
46400;63000;9;14;4;5;0;0;0;1
69000;155000;28;47;4;19;0;0;0;1
52000;112500;32;67;4;35;0;0;0;1
40000;103000;9;35;4;26;0;0;0;1
39500;46000;29;32;4;3;0;0;0;1
49000;60000;13;17;4;4;0;0;0;1
24900;49900;13;33;4;20;0;0;0;1
33000;55000;24;32;4;8;0;0;0;1
31500;48000;8;27;4;19;0;0;0;1
24800;29900;4;12;4;8;0;0;0;1
53900;118500;28;58;4;30;0;0;0;1
94000;141000;34;50;4;16;0;0;0;1
72700;80000;29;35;4;6;0;0;0;1
49000;108000;27;61;4;34;0;0;0;1
35300;54900;22;32;4;10;0;0;0;1
39800;58200;26;33;4;7;0;0;0;1
38900;59000;14;28;4;14;0;0;0;1
1154000;1079000;57;60;4;3;0;0;0;1
45000;118000;26;55;4;29;0;0;0;1
18000;42000;18;32;4;14;0;0;0;1
22500;55900;21;29;4;8;0;0;0;1
31600;113200;9;67;4;58;0;0;0;1
19000;27000;7;18;4;11;0;0;0;1
38500;54000;27;32;4;5;0;0;0;1
54900;70000;28;33;4;5;0;0;0;1
46200;49000;10;16;4;6;0;0;0;1
21100;37000;12;29;4;17;0;0;0;1
39900;125000;13;36;4;23;0;0;0;1
34000;38000;7;11;4;4;0;0;0;1
34500;41500;12;16;4;4;0;0;0;1
19000;57200;23;57;4;34;0;0;0;1
51900;68800;13;21;4;8;0;0;0;1
63000;240000;23;66;4;43;0;0;0;1
79500;135000;34;55;4;21;0;0;0;1
28300;57900;18;32;4;14;0;0;0;1
25500;44500;22;33;4;11;0;0;0;1
35000;43500;19;27;4;8;0;0;0;1
48000;55000;19;22;4;3;0;0;0;1
84000;152000;36;59;4;23;0;0;0;1
292000;292000;20;21;4;1;0;0;0;1
325000;325000;11;12;4;1;0;0;0;1
28000;32500;4;11;4;7;0;0;0;1
57900;87000;34;47;4;13;0;0;0;1
69500;71000;32;36;4;4;0;0;0;1
75600;135000;34;51;4;17;0;0;0;1
26500;58500;20;35;4;15;0;0;0;1
27600;36500;9;24;4;15;0;0;0;1
43200;68000;22;32;4;10;0;0;0;1
31700;44500;13;23;4;10;0;0;0;1
47500;52500;24;27;4;3;0;0;0;1
35000;48900;25;30;4;5;0;0;0;1
33000;38500;2;11;4;9;0;0;0;1
22800;91000;8;62;4;54;0;0;0;1
25000;32500;3;19;4;16;0;0;0;1
1140000;1060000;54;57;4;3;0;0;0;1
26200;61200;12;36;4;24;0;0;0;1
27200;39000;17;27;4;10;0;0;0;1
143000;172000;58;66;4;8;0;0;0;1
62600;85000;27;32;4;5;0;0;0;1
113000;139900;44;56;4;12;0;0;0;1
64500;121000;31;61;4;30;0;0;0;1
38000;54900;14;26;4;12;0;0;0;1
32500;40000;1;17;4;16;0;0;0;1
45200;60800;3;24;4;21;0;0;0;1
44000;46000;26;29;4;3;0;0;0;1
41500;49900;28;29;4;1;0;0;0;1
64000;123000;34;57;4;23;0;0;0;1
33500;40300;15;28;4;13;0;0;0;1
32000;74500;13;34;4;21;0;0;0;1
36100;64900;22;31;4;9;0;0;0;1
87000;222000;29;67;4;38;0;0;0;1
64000;92500;26;33;4;7;0;0;0;1
95000;100000;27;29;4;2;0;0;0;1
38500;83000;14;35;4;21;0;0;0;1
42500;125000;11;35;4;24;0;0;0;1
56600;69000;29;34;4;5;0;0;0;1
36600;75000;28;59;4;31;0;0;0;1
33700;52000;9;25;4;16;0;0;0;1
45500;62500;22;25;4;3;0;0;0;1
24000;36000;23;32;4;9;0;0;0;1
27700;36500;22;27;4;5;0;0;0;1
20000;30000;9;25;4;16;0;0;0;1
25700;28000;6;14;4;8;0;0;0;1
59000;95000;30;45;4;15;0;0;0;1
33200;52000;10;24;4;14;0;0;0;1
23000;52500;22;36;4;14;0;0;0;1
44000;75000;14;30;4;16;0;0;0;1
31000;34100;11;14;4;3;0;0;0;1
32000;46000;13;26;4;13;0;0;0;1
35500;53500;28;29;4;1;0;0;0;1
78000;128000;30;49;4;19;0;0;0;1
44500;60000;10;21;4;11;0;0;0;1
46000;68000;30;35;4;5;0;0;0;1
25000;27400;10;20;4;10;0;0;0;1
36500;83000;8;36;4;28;0;0;0;1
1125000;1125000;53;54;4;1;0;0;0;1
18500;36000;5;29;4;24;0;0;0;1
57900;108000;28;42;4;14;0;0;0;1
45500;72500;23;32;4;9;0;0;0;1
39300;74500;18;30;4;12;0;0;0;1
27000;41600;10;26;4;16;0;0;0;1
23000;65500;27;64;4;37;0;0;0;1
40000;118500;18;56;4;38;0;0;0;1
22000;40900;7;28;4;21;0;0;0;1
60500;103000;19;37;4;18;0;0;0;1
134500;184000;44;66;4;22;0;0;0;1
56900;84500;20;30;4;10;0;0;0;1
46000;53000;4;11;4;7;0;0;0;1
31500;65000;8;31;4;23;0;0;0;1
43700;56000;17;27;4;10;0;0;0;1
35500;49000;11;26;4;15;0;0;0;1
42700;45800;24;27;4;3;0;0;0;1
67000;85000;23;28;4;5;0;0;0;1
44700;61000;13;20;4;7;0;0;0;1
49000;109000;27;47;4;20;0;0;0;1
47500;52900;15;19;4;4;0;0;0;1
39200;48000;17;22;4;5;0;0;0;1
82900;114900;34;43;4;9;0;0;0;1
40000;47900;24;29;4;5;0;0;0;1
26000;54000;7;30;4;23;0;0;0;1
98000;175000;36;62;4;26;0;0;0;1
29200;95000;13;45;4;32;0;0;0;1
36000;49000;17;26;4;9;0;0;0;1
55000;59000;25;28;4;3;0;0;0;1
30500;52000;14;29;4;15;0;0;0;1
60000;115000;21;31;4;10;0;0;0;1
55000;97500;30;57;4;27;0;0;0;1
25500;36900;26;35;4;9;0;0;0;1
28100;38000;6;21;4;15;0;0;0;1
43900;122500;16;58;4;42;0;0;0;1
29000;44000;23;30;4;7;0;0;0;1
19500;22000;1;22;4;21;0;0;0;1
30500;55000;16;29;4;13;0;0;0;1
46400;58500;17;23;4;6;0;0;0;1
120000;225000;36;59;4;23;0;0;0;1
125500;225000;33;64;4;31;0;0;0;1
42500;58000;26;30;4;4;0;0;0;1
47500;59000;28;33;4;5;0;0;0;1
94900;115000;42;56;4;14;0;0;0;1
56900;107500;27;49;4;22;0;0;0;1
48000;148000;14;55;4;41;0;0;0;1
72000;233500;25;54;4;29;0;0;0;1
63000;94000;36;50;4;14;0;0;0;1
91000;155000;35;57;4;22;0;0;0;1
110600;125000;42;62;4;20;0;0;0;1
82000;92900;42;46;4;4;0;0;0;1
35500;44500;7;15;4;8;0;0;0;1
45000;125000;27;64;4;37;0;0;0;1
36500;63000;24;33;4;9;0;0;0;1
101000;209900;34;66;4;32;0;0;0;1
37500;58500;25;32;4;7;0;0;0;1
29000;89000;11;44;4;33;0;0;0;1
38100;94000;20;43;4;23;0;0;0;1
29500;79500;6;31;4;25;0;0;0;1
26600;29000;4;9;4;5;0;0;0;1
33500;63500;21;33;4;12;0;0;0;1
31600;101500;22;58;4;36;0;0;0;1
2200000;1900000;44;55;4;11;0;0;0;1
40000;57900;28;35;4;7;0;0;0;1
25300;84000;14;56;4;42;0;0;0;1
55900;114900;29;61;4;32;0;0;0;1
100000;176000;34;58;4;24;0;0;0;1
58900;91000;30;44;4;14;0;0;0;1
43500;59900;29;30;4;1;0;0;0;1
99000;245000;28;54;4;26;0;0;0;1
46900;63000;25;30;4;5;0;0;0;1
32500;40500;20;27;4;7;0;0;0;1
36000;60000;8;25;4;17;0;0;0;1
32500;49500;8;24;4;16;0;0;0;1
50000;65000;27;34;4;7;0;0;0;1
1020000;1020000;55;56;4;1;0;0;0;1
45500;49500;24;27;4;3;0;0;0;1
35900;84500;4;34;4;30;0;0;0;1
25000;43500;8;27;4;19;0;0;0;1
40000;48900;16;23;4;7;0;0;0;1
28500;32000;21;26;4;5;0;0;0;1
85000;115000;26;33;4;7;0;0;0;1
35200;45500;16;23;4;7;0;0;0;1
43900;47200;20;25;4;5;0;0;0;1
24000;66000;5;35;4;30;0;0;0;1
835000;750000;47;55;4;8;0;0;0;1
76000;112000;31;46;4;15;0;0;0;1
45000;93200;18;35;4;17;0;0;0;1
42800;85000;12;32;4;20;0;0;0;1
40000;50000;8;13;4;5;0;0;0;1
65000;96500;33;55;4;22;0;0;0;1
33900;38000;27;29;4;2;0;0;0;1
45500;150000;11;51;4;40;0;0;0;1
32500;52000;15;29;4;14;0;0;0;1
18300;34500;1;26;4;25;0;0;0;1
59500;67000;29;33;4;4;0;0;0;1
23000;88500;24;65;4;41;0;0;0;1
93500;245000;14;35;4;21;0;0;0;1
34900;36000;23;26;4;3;0;0;0;1
71500;104000;33;47;4;14;0;0;0;1
38000;108800;23;67;4;44;0;0;0;1
46000;62500;27;30;4;3;0;0;0;1
20300;29200;4;17;4;13;0;0;0;1
85300;148000;31;58;4;27;0;0;0;1
43500;127500;18;54;4;36;0;0;0;1
41000;105500;26;55;4;29;0;0;0;1
45800;73000;19;30;4;11;0;0;0;1
77700;83500;31;36;4;5;0;0;0;1
72900;105000;36;44;4;8;0;0;0;1
32500;68000;16;32;4;16;0;0;0;1
118500;166000;35;51;4;16;0;0;0;1
44000;130000;20;57;4;37;0;0;0;1
21600;34500;15;29;4;14;0;0;0;1
65900;103000;37;57;4;20;0;0;0;1
47700;54900;21;24;4;3;0;0;0;1
97000;108000;44;56;4;12;0;0;0;1
43500;71500;33;47;4;14;0;0;0;1
41400;144000;12;60;4;48;0;0;0;1
57200;63000;22;25;4;3;0;0;0;1
35000;65500;23;36;4;13;0;0;0;1
63000;77000;27;30;4;3;0;0;0;1
117700;118000;60;61;4;1;0;0;0;1
1250000;1249000;46;56;4;10;0;0;0;1
58000;96500;34;56;4;22;0;0;0;1
49500;98500;17;33;4;16;0;0;0;1
35500;46500;4;17;4;13;0;0;0;1
1193000;1185000;55;56;4;1;0;0;0;1
59700;77500;5;22;4;17;0;0;0;1
42000;54200;10;25;4;15;0;0;0;1
150000;182500;47;65;4;18;0;0;0;1
19500;25800;4;20;4;16;0;0;0;1
53900;90000;25;36;4;11;0;0;0;1
53800;83500;26;33;4;7;0;0;0;1
28500;58500;12;30;4;18;0;0;0;1
25800;72000;20;57;4;37;0;0;0;1
24500;27000;8;10;4;2;0;0;0;1
50000;120000;21;50;4;29;0;0;0;1
98900;113000;44;57;4;13;0;0;0;1
58500;140000;31;63;4;32;0;0;0;1
53400;84000;17;28;4;11;0;0;0;1
37500;135000;21;50;4;29;0;0;0;1
118500;139500;52;66;4;14;0;0;0;1
50000;105000;13;31;4;18;0;0;0;1
19900;42500;10;30;4;20;0;0;0;1
66000;68500;30;34;4;4;0;0;0;1
36000;57500;6;19;4;13;0;0;0;1
30000;33900;4;10;4;6;0;0;0;1
102000;149900;34;44;4;10;0;0;0;1
40000;56900;13;22;4;9;0;0;0;1
34500;148900;14;62;4;48;0;0;0;1
33500;44000;28;36;4;8;0;0;0;1
86900;160500;31;60;4;29;0;0;0;1
69900;94000;28;35;4;7;0;0;0;1
67500;104000;24;35;4;11;0;0;0;1
79900;120000;36;55;4;19;0;0;0;1
60600;72500;20;28;4;8;0;0;0;1
57000;117500;14;31;4;17;0;0;0;1
27000;39000;24;28;4;4;0;0;0;1
41900;99300;21;49;4;28;0;0;0;1
78500;90000;41;58;4;17;0;0;0;1
21000;43100;6;30;4;24;0;0;0;1
61000;77500;26;34;4;8;0;0;0;1
74200;189000;25;58;4;33;0;0;0;1
26500;125000;12;53;4;41;0;0;0;1
16800;47000;21;43;4;22;0;0;0;1
32500;48000;6;23;4;17;0;0;0;1
82500;225000;28;57;4;29;0;0;0;1
60000;66800;53;57;4;4;0;0;0;1
35000;83000;28;60;4;32;0;0;0;1
28200;68900;13;36;4;23;0;0;0;1